општина,конто,опис конта,република ,аутономна покрајина,општина града,ООСО,донације,остали извори,укупно
НОВИ САД,411,"ПЛАТЕ, ДОДАЦИ И НАКНАДЕ ЗАПОСЛЕНИХ (ЗАРАДЕ) (5174)",672232,1448779,30972,0,0,19811,2171794
НОВИ САД,412,СОЦИЈАЛНИ ДОПРИНОСИ НА ТЕРЕТ ПОСЛОДАВЦА (од 5176 до 5178),126069,259038,5544,0,0,3433,394084
НОВИ САД,413,НАКНАДЕ У НАТУРИ (5180),13796,15620,315,0,0,1437,31168
НОВИ САД,414,СОЦИЈАЛНА ДАВАЊА ЗАПОСЛЕНИМА (од 5182 до 5185),6597,7678,0,0,0,17515,31790
НОВИ САД,415,НАКНАДА ТРОШКОВА ЗА ЗАПОСЛЕНЕ (5187),18221,33220,10,0,0,1160,52611
НОВИ САД,416,НАГРАДЕ ЗАПОСЛЕНИМА И ОСТАЛИ ПОСЕБНИ РАСХОДИ (5189),5,3571,0,0,0,5730,9306
НОВИ САД,417,ПОСЛАНИЧКИ ДОДАТАК (5191),0,101277,0,0,0,0,101277
НОВИ САД,418,СУДИЈСКИ ДОДАТАК (5193),0,0,0,0,0,0,0
НОВИ САД,421,СТАЛНИ ТРОШКОВИ (од 5196 до 5202),9232,301395,6115,0,248,12520,329510
НОВИ САД,422,ТРОШКОВИ ПУТОВАЊА (од 5204 до 5208),9660,60240,0,0,4465,13812,88177
НОВИ САД,423,УСЛУГЕ ПО УГОВОРУ (од 5210 до 5217),12045,338705,461,0,21416,64033,436660
НОВИ САД,424,СПЕЦИЈАЛИЗОВАНЕ УСЛУГЕ (од 5219 до 5225),86780,438918,8023,0,10195,49117,593033
НОВИ САД,425,ТЕКУЋЕ ПОПРАВКЕ И ОДРЖАВАЊЕ (5227 + 5228),1528,48888,0,0,0,7384,57800
НОВИ САД,426,МАТЕРИЈАЛ (од 5230 до 5238),14014,346713,5235,0,606,15211,381779
НОВИ САД,431,АМОРТИЗАЦИЈА НЕКРЕТНИНА И ОПРЕМЕ (од 5241 до 5243),0,0,0,0,0,5277,5277
НОВИ САД,432,АМОРТИЗАЦИЈА КУЛТИВИСАНЕ ИМОВИНЕ (5245),0,0,0,0,0,0,0
НОВИ САД,433,УПОТРЕБА ДРАГОЦЕНОСТИ (5247),0,0,0,0,0,0,0
НОВИ САД,434,УПОТРЕБА ПРИРОДНЕ ИМОВИНЕ (од 5249 до 5251),0,0,0,0,0,0,0
НОВИ САД,435,АМОРТИЗАЦИЈА НЕМАТЕРИЈАЛНЕ ИМОВИНЕ (5253),0,0,0,0,0,280,280
НОВИ САД,441,ОТПЛАТЕ ДОМАЋИХ КАМАТА (од 5256 до 5264),0,0,0,0,0,1,1
НОВИ САД,442,ОТПЛАТА СТРАНИХ КАМАТА (од 5266 до 5271),0,0,0,0,0,0,0
НОВИ САД,443,ОТПЛАТА КАМАТА ПО ГАРАНЦИЈАМА (5273),0,0,0,0,0,0,0
НОВИ САД,444,ПРАТЕЋИ ТРОШКОВИ ЗАДУЖИВАЊА (од 5275 до 5277),0,247,0,0,0,679,926
НОВИ САД,451,СУБВЕНЦИЈЕ ЈАВНИМ НЕФИНАНСИЈСКИМ ПРЕДУЗЕЋИМА И ОРГАНИЗАЦИЈАМА (5280 + 5281),4000,926371,0,0,0,873229,1803600
НОВИ САД,452,СУБВЕНЦИЈЕ ПРИВАТНИМ ФИНАНСИЈСКИМ ИНСТИТУЦИЈАМА (5283 + 5284),0,0,0,0,0,0,0
НОВИ САД,453,СУБВЕНЦИЈЕ ЈАВНИМ ФИНАНСИЈСКИМ ИНСТИТУЦИЈАМА (5286 + 5287),0,0,0,0,0,0,0
НОВИ САД,454,СУБВЕНЦИЈЕ ПРИВАТНИМ ПРЕДУЗЕЋИМА (5289 + 5290),0,2241118,0,0,0,3700,2244818
НОВИ САД,461,ДОНАЦИЈЕ СТРАНИМ ВЛАДАМА (5293 + 5294),0,0,0,0,0,0,0
НОВИ САД,462,ДОТАЦИЈЕ МЕЂУНАРОДНИМ ОРГАНИЗАЦИЈАМА (5296 + 5297),0,11621,0,0,0,0,11621
НОВИ САД,463,ТРАНСФЕРИ ОСТАЛИМ НИВОИМА ВЛАСТИ (5299 + 5300),30775621,1478671,0,0,144341,1094914,33493547
НОВИ САД,464,ДОТАЦИЈЕ ОРГАНИЗАЦИЈАМА ОБАВЕЗНОГ СОЦИЈАЛНОГ ОСИГУРАЊА (5302 + 5303),0,0,0,0,0,0,0
НОВИ САД,465,ОСТАЛЕ ДОТАЦИЈЕ И ТРАНСФЕРИ (5305 + 5306),0,204803,0,0,45203,169,250175
НОВИ САД,471,ПРАВА ИЗ СОЦИЈАЛНОГ ОСИГУРАЊА (ОРГАНИЗАЦИЈЕ ОБАВЕЗНОГ СОЦИЈАЛНОГ ОСИГУРАЊА) (од 5309 до 5311),0,0,0,0,0,0,0
НОВИ САД,472,НАКНАДЕ ЗА СОЦИЈАЛНУ ЗАШТИТУ ИЗ БУЏЕТА (од 5313 до 5321),0,400796,0,0,809,154,401759
НОВИ САД,481,ДОТАЦИЈЕ НЕВЛАДИНИМ ОРГАНИЗАЦИЈАМА (5324 + 5325),270,749996,115,0,16212,434,767027
НОВИ САД,482,"ПОРЕЗИ, ОБАВЕЗНЕ ТАКСЕ И КАЗНЕ (од 5327 до 5329)",12,5716,0,0,128,3507,9363
НОВИ САД,483,НОВЧАНЕ КАЗНЕ И ПЕНАЛИ ПО РЕШЕЊУ СУДОВА (5331),0,9637,0,0,0,1445,11082
НОВИ САД,484,НАКНАДА ШТЕТЕ ЗА ПОВРЕДЕ ИЛИ ШТЕТУ НАСТАЛУ УСЛЕД ЕЛЕМЕНТАРНИХ НЕПОГОДА ИЛИ ДРУГИХ ПРИРОДНИХ УЗРОКА (5333 + 5334),0,0,0,0,0,6,6
НОВИ САД,485,НАКНАДА ШТЕТЕ ЗА ПОВРЕДЕ ИЛИ ШТЕТУ НАНЕТУ ОД СТРАНЕ ДРЖАВНИХ ОРГАНА (5336),0,0,0,0,0,60,60
НОВИ САД,489,РАСХОДИ КОЈИ СЕ ФИНАНСИРАЈУ ИЗ СРЕДСТАВА ЗА РЕАЛИЗАЦИЈУ НАЦИОНАЛНОГ ИНВЕСТИЦИОНОГ ПЛАНА (5338),0,0,0,0,0,0,0
НОВИ САД,511,ЗГРАДЕ И ГРАЂЕВИНСКИ ОБЈЕКТИ (од 5342 до 5345),0,51913,4000,0,10,54,55977
НОВИ САД,512,МАШИНЕ И ОПРЕМА (од 5347 до 5355),2701,62931,0,0,17700,4308,87640
НОВИ САД,513,ОСТАЛЕ НЕКРЕТНИНЕ И ОПРЕМА (5357),0,0,0,0,0,0,0
НОВИ САД,514,КУЛТИВИСАНА ИМОВИНА (5359),0,0,0,0,0,0,0
НОВИ САД,515,НЕМАТЕРИЈАЛНА ИМОВИНА (5361),419,87680,0,0,6639,2637,97375
НОВИ САД,521,РОБНЕ РЕЗЕРВЕ (5364),0,99950,0,0,0,350,100300
НОВИ САД,522,ЗАЛИХЕ ПРОИЗВОДЊЕ (од 5366 до 5368),0,0,0,0,0,0,0
НОВИ САД,523,ЗАЛИХЕ РОБЕ ЗА ДАЉУ ПРОДАЈУ (5370),0,0,0,0,0,815,815
НОВИ САД,531,ДРАГОЦЕНОСТИ (5373),0,0,0,0,0,0,0
НОВИ САД,541,ЗЕМЉИШТЕ (5376),0,0,0,0,0,0,0
НОВИ САД,542,РУДНА БОГАТСТВА (5378),0,0,0,0,0,0,0
НОВИ САД,543,ШУМЕ И ВОДЕ (5380 + 5381),0,0,0,0,0,0,0
НОВИ САД,551,НЕФИНАНСИЈСКА ИМОВИНА КОЈА СЕ ФИНАНСИРА ИЗ СРЕДСТАВА ЗА РЕАЛИЗАЦИЈУ НАЦИОНАЛНОГ ИНВЕСТИЦИОНОГ ПЛАНА (5384),300000,6955401,0,0,0,0,7255401
НОВИ САД,611,ОТПЛАТА ГЛАВНИЦЕ ДОМАЋИМ КРЕДИТОРИМА (од 5388 до 5396),0,0,0,0,0,0,0
НОВИ САД,612,ОТПЛАТА ГЛАВНИЦЕ СТРАНИМ КРЕДИТОРИМА (од 5398 до 5404),0,0,0,0,0,0,0
НОВИ САД,613,ОТПЛАТА ГЛАВНИЦЕ ПО ГАРАНЦИЈАМА (5406),0,0,0,0,0,0,0
НОВИ САД,614,ОТПЛАТА ГЛАВНИЦЕ ЗА ФИНАНСИЈСКИ ЛИЗИНГ (5408),0,0,0,0,0,0,0
НОВИ САД,621,НАБАВКА ДОМАЋЕ ФИНАНСИЈСКЕ ИМОВИНЕ (од 5411 до 5419),0,1146863,0,0,0,0,1146863
НОВИ САД,622,НАБАВКА СТРАНЕ ФИНАНСИЈСКЕ ИМОВИНЕ (од 5421 до 5428),0,0,0,0,0,0,0
НОВИ САД,623,НАБАВКА ФИНАНСИЈСКЕ ИМОВИНЕ КОЈА СЕ ФИНАНСИРА ИЗ СРЕДСТАВА ЗА РЕАЛИЗАЦИЈУ НАЦИОНАЛНОГ ИНВЕСТИЦИОНОГ ПЛАНА (5430),0,0,0,0,0,0,0
КРАГУЈЕВАЦ,411,"ПЛАТЕ, ДОДАЦИ И НАКНАДЕ ЗАПОСЛЕНИХ (ЗАРАДЕ) (5174)",25141,0,827553,0,20,26496,879210
КРАГУЈЕВАЦ,412,СОЦИЈАЛНИ ДОПРИНОСИ НА ТЕРЕТ ПОСЛОДАВЦА (од 5176 до 5178),7602,0,148877,0,0,1468,157947
КРАГУЈЕВАЦ,413,НАКНАДЕ У НАТУРИ (5180),0,0,306,0,0,917,1223
КРАГУЈЕВАЦ,414,СОЦИЈАЛНА ДАВАЊА ЗАПОСЛЕНИМА (од 5182 до 5185),15997,0,52695,0,0,2863,71555
КРАГУЈЕВАЦ,415,НАКНАДА ТРОШКОВА ЗА ЗАПОСЛЕНЕ (5187),3308,0,26391,0,0,5847,35546
КРАГУЈЕВАЦ,416,НАГРАДЕ ЗАПОСЛЕНИМА И ОСТАЛИ ПОСЕБНИ РАСХОДИ (5189),0,0,10416,0,0,34,10450
КРАГУЈЕВАЦ,417,ПОСЛАНИЧКИ ДОДАТАК (5191),0,0,0,0,0,0,0
КРАГУЈЕВАЦ,418,СУДИЈСКИ ДОДАТАК (5193),0,0,0,0,0,0,0
КРАГУЈЕВАЦ,421,СТАЛНИ ТРОШКОВИ (од 5196 до 5202),3789,0,84359,0,385,28844,117377
КРАГУЈЕВАЦ,422,ТРОШКОВИ ПУТОВАЊА (од 5204 до 5208),647,0,11284,0,314,11744,23989
КРАГУЈЕВАЦ,423,УСЛУГЕ ПО УГОВОРУ (од 5210 до 5217),1357,0,200862,0,1491,16679,220389
КРАГУЈЕВАЦ,424,СПЕЦИЈАЛИЗОВАНЕ УСЛУГЕ (од 5219 до 5225),16136,0,384307,0,0,132330,532773
КРАГУЈЕВАЦ,425,ТЕКУЋЕ ПОПРАВКЕ И ОДРЖАВАЊЕ (5227 + 5228),208,0,14441,0,2817,9460,26926
КРАГУЈЕВАЦ,426,МАТЕРИЈАЛ (од 5230 до 5238),4345,0,33570,0,36,40417,78368
КРАГУЈЕВАЦ,431,АМОРТИЗАЦИЈА НЕКРЕТНИНА И ОПРЕМЕ (од 5241 до 5243),0,0,0,0,0,371,371
КРАГУЈЕВАЦ,432,АМОРТИЗАЦИЈА КУЛТИВИСАНЕ ИМОВИНЕ (5245),0,0,0,0,0,0,0
КРАГУЈЕВАЦ,433,УПОТРЕБА ДРАГОЦЕНОСТИ (5247),0,0,0,0,0,0,0
КРАГУЈЕВАЦ,434,УПОТРЕБА ПРИРОДНЕ ИМОВИНЕ (од 5249 до 5251),0,0,0,0,0,0,0
КРАГУЈЕВАЦ,435,АМОРТИЗАЦИЈА НЕМАТЕРИЈАЛНЕ ИМОВИНЕ (5253),0,0,0,0,0,21,21
КРАГУЈЕВАЦ,441,ОТПЛАТЕ ДОМАЋИХ КАМАТА (од 5256 до 5264),0,0,47439,0,0,37,47476
КРАГУЈЕВАЦ,442,ОТПЛАТА СТРАНИХ КАМАТА (од 5266 до 5271),0,0,16629,0,0,0,16629
КРАГУЈЕВАЦ,443,ОТПЛАТА КАМАТА ПО ГАРАНЦИЈАМА (5273),0,0,0,0,0,0,0
КРАГУЈЕВАЦ,444,ПРАТЕЋИ ТРОШКОВИ ЗАДУЖИВАЊА (од 5275 до 5277),6,0,470,0,0,36,512
КРАГУЈЕВАЦ,451,СУБВЕНЦИЈЕ ЈАВНИМ НЕФИНАНСИЈСКИМ ПРЕДУЗЕЋИМА И ОРГАНИЗАЦИЈАМА (5280 + 5281),0,0,295948,0,0,60871,356819
КРАГУЈЕВАЦ,452,СУБВЕНЦИЈЕ ПРИВАТНИМ ФИНАНСИЈСКИМ ИНСТИТУЦИЈАМА (5283 + 5284),0,0,7028,0,0,1792,8820
КРАГУЈЕВАЦ,453,СУБВЕНЦИЈЕ ЈАВНИМ ФИНАНСИЈСКИМ ИНСТИТУЦИЈАМА (5286 + 5287),0,0,0,0,0,0,0
КРАГУЈЕВАЦ,454,СУБВЕНЦИЈЕ ПРИВАТНИМ ПРЕДУЗЕЋИМА (5289 + 5290),0,0,0,0,0,0,0
КРАГУЈЕВАЦ,461,ДОНАЦИЈЕ СТРАНИМ ВЛАДАМА (5293 + 5294),0,0,0,0,0,0,0
КРАГУЈЕВАЦ,462,ДОТАЦИЈЕ МЕЂУНАРОДНИМ ОРГАНИЗАЦИЈАМА (5296 + 5297),0,0,0,0,0,0,0
КРАГУЈЕВАЦ,463,ТРАНСФЕРИ ОСТАЛИМ НИВОИМА ВЛАСТИ (5299 + 5300),1750,0,186656,0,2603,0,191009
КРАГУЈЕВАЦ,464,ДОТАЦИЈЕ ОРГАНИЗАЦИЈАМА ОБАВЕЗНОГ СОЦИЈАЛНОГ ОСИГУРАЊА (5302 + 5303),0,0,0,0,0,0,0
КРАГУЈЕВАЦ,465,ОСТАЛЕ ДОТАЦИЈЕ И ТРАНСФЕРИ (5305 + 5306),0,0,0,0,75,75,150
КРАГУЈЕВАЦ,471,ПРАВА ИЗ СОЦИЈАЛНОГ ОСИГУРАЊА (ОРГАНИЗАЦИЈЕ ОБАВЕЗНОГ СОЦИЈАЛНОГ ОСИГУРАЊА) (од 5309 до 5311),0,0,0,0,0,0,0
КРАГУЈЕВАЦ,472,НАКНАДЕ ЗА СОЦИЈАЛНУ ЗАШТИТУ ИЗ БУЏЕТА (од 5313 до 5321),23110,0,35882,0,185,5,59182
КРАГУЈЕВАЦ,481,ДОТАЦИЈЕ НЕВЛАДИНИМ ОРГАНИЗАЦИЈАМА (5324 + 5325),1515,0,179835,0,230,769,182349
КРАГУЈЕВАЦ,482,"ПОРЕЗИ, ОБАВЕЗНЕ ТАКСЕ И КАЗНЕ (од 5327 до 5329)",18,0,5266,0,0,843,6127
КРАГУЈЕВАЦ,483,НОВЧАНЕ КАЗНЕ И ПЕНАЛИ ПО РЕШЕЊУ СУДОВА (5331),355,0,62771,0,0,1314,64440
КРАГУЈЕВАЦ,484,НАКНАДА ШТЕТЕ ЗА ПОВРЕДЕ ИЛИ ШТЕТУ НАСТАЛУ УСЛЕД ЕЛЕМЕНТАРНИХ НЕПОГОДА ИЛИ ДРУГИХ ПРИРОДНИХ УЗРОКА (5333 + 5334),0,0,12932,0,0,1923,14855
КРАГУЈЕВАЦ,485,НАКНАДА ШТЕТЕ ЗА ПОВРЕДЕ ИЛИ ШТЕТУ НАНЕТУ ОД СТРАНЕ ДРЖАВНИХ ОРГАНА (5336),0,0,1304,0,0,69,1373
КРАГУЈЕВАЦ,489,РАСХОДИ КОЈИ СЕ ФИНАНСИРАЈУ ИЗ СРЕДСТАВА ЗА РЕАЛИЗАЦИЈУ НАЦИОНАЛНОГ ИНВЕСТИЦИОНОГ ПЛАНА (5338),0,0,0,0,0,0,0
КРАГУЈЕВАЦ,511,ЗГРАДЕ И ГРАЂЕВИНСКИ ОБЈЕКТИ (од 5342 до 5345),732,0,234782,0,6470,28071,270055
КРАГУЈЕВАЦ,512,МАШИНЕ И ОПРЕМА (од 5347 до 5355),399,0,10142,0,929,9675,21145
КРАГУЈЕВАЦ,513,ОСТАЛЕ НЕКРЕТНИНЕ И ОПРЕМА (5357),0,0,0,0,0,40,40
КРАГУЈЕВАЦ,514,КУЛТИВИСАНА ИМОВИНА (5359),0,0,0,0,0,0,0
КРАГУЈЕВАЦ,515,НЕМАТЕРИЈАЛНА ИМОВИНА (5361),53,0,2009,0,0,54,2116
КРАГУЈЕВАЦ,521,РОБНЕ РЕЗЕРВЕ (5364),0,0,1812,0,0,26744,28556
КРАГУЈЕВАЦ,522,ЗАЛИХЕ ПРОИЗВОДЊЕ (од 5366 до 5368),0,0,0,0,0,24,24
КРАГУЈЕВАЦ,523,ЗАЛИХЕ РОБЕ ЗА ДАЉУ ПРОДАЈУ (5370),0,0,0,0,0,1218,1218
КРАГУЈЕВАЦ,531,ДРАГОЦЕНОСТИ (5373),0,0,0,0,0,0,0
КРАГУЈЕВАЦ,541,ЗЕМЉИШТЕ (5376),0,0,34032,0,0,15446,49478
КРАГУЈЕВАЦ,542,РУДНА БОГАТСТВА (5378),0,0,0,0,0,0,0
КРАГУЈЕВАЦ,543,ШУМЕ И ВОДЕ (5380 + 5381),0,0,0,0,0,0,0
КРАГУЈЕВАЦ,551,НЕФИНАНСИЈСКА ИМОВИНА КОЈА СЕ ФИНАНСИРА ИЗ СРЕДСТАВА ЗА РЕАЛИЗАЦИЈУ НАЦИОНАЛНОГ ИНВЕСТИЦИОНОГ ПЛАНА (5384),0,0,0,0,0,0,0
КРАГУЈЕВАЦ,611,ОТПЛАТА ГЛАВНИЦЕ ДОМАЋИМ КРЕДИТОРИМА (од 5388 до 5396),0,0,215238,0,0,0,215238
КРАГУЈЕВАЦ,612,ОТПЛАТА ГЛАВНИЦЕ СТРАНИМ КРЕДИТОРИМА (од 5398 до 5404),0,0,173784,0,0,0,173784
КРАГУЈЕВАЦ,613,ОТПЛАТА ГЛАВНИЦЕ ПО ГАРАНЦИЈАМА (5406),0,0,0,0,0,0,0
КРАГУЈЕВАЦ,614,ОТПЛАТА ГЛАВНИЦЕ ЗА ФИНАНСИЈСКИ ЛИЗИНГ (5408),0,0,0,0,0,0,0
КРАГУЈЕВАЦ,621,НАБАВКА ДОМАЋЕ ФИНАНСИЈСКЕ ИМОВИНЕ (од 5411 до 5419),0,0,0,0,0,0,0
КРАГУЈЕВАЦ,622,НАБАВКА СТРАНЕ ФИНАНСИЈСКЕ ИМОВИНЕ (од 5421 до 5428),0,0,0,0,0,0,0
КРАГУЈЕВАЦ,623,НАБАВКА ФИНАНСИЈСКЕ ИМОВИНЕ КОЈА СЕ ФИНАНСИРА ИЗ СРЕДСТАВА ЗА РЕАЛИЗАЦИЈУ НАЦИОНАЛНОГ ИНВЕСТИЦИОНОГ ПЛАНА (5430),0,0,0,0,0,0,0
БАТОЧИНА,411,"ПЛАТЕ, ДОДАЦИ И НАКНАДЕ ЗАПОСЛЕНИХ (ЗАРАДЕ) (5174)",0,0,38852,0,0,66,38918
БАТОЧИНА,412,СОЦИЈАЛНИ ДОПРИНОСИ НА ТЕРЕТ ПОСЛОДАВЦА (од 5176 до 5178),0,0,6954,0,0,11,6965
БАТОЧИНА,413,НАКНАДЕ У НАТУРИ (5180),0,0,94,0,0,0,94
БАТОЧИНА,414,СОЦИЈАЛНА ДАВАЊА ЗАПОСЛЕНИМА (од 5182 до 5185),315,0,1129,0,0,848,2292
БАТОЧИНА,415,НАКНАДА ТРОШКОВА ЗА ЗАПОСЛЕНЕ (5187),399,0,359,0,0,97,855
БАТОЧИНА,416,НАГРАДЕ ЗАПОСЛЕНИМА И ОСТАЛИ ПОСЕБНИ РАСХОДИ (5189),0,0,26,0,0,154,180
БАТОЧИНА,417,ПОСЛАНИЧКИ ДОДАТАК (5191),0,0,0,0,0,0,0
БАТОЧИНА,418,СУДИЈСКИ ДОДАТАК (5193),0,0,0,0,0,0,0
БАТОЧИНА,421,СТАЛНИ ТРОШКОВИ (од 5196 до 5202),2384,0,32820,0,241,1040,36485
БАТОЧИНА,422,ТРОШКОВИ ПУТОВАЊА (од 5204 до 5208),97,0,972,0,0,100,1169
БАТОЧИНА,423,УСЛУГЕ ПО УГОВОРУ (од 5210 до 5217),1300,0,7014,0,113,335,8762
БАТОЧИНА,424,СПЕЦИЈАЛИЗОВАНЕ УСЛУГЕ (од 5219 до 5225),2418,0,18236,0,0,209,20863
БАТОЧИНА,425,ТЕКУЋЕ ПОПРАВКЕ И ОДРЖАВАЊЕ (5227 + 5228),68,0,5229,0,87,299,5683
БАТОЧИНА,426,МАТЕРИЈАЛ (од 5230 до 5238),525,0,4261,0,26,1858,6670
БАТОЧИНА,431,АМОРТИЗАЦИЈА НЕКРЕТНИНА И ОПРЕМЕ (од 5241 до 5243),0,0,0,0,0,0,0
БАТОЧИНА,432,АМОРТИЗАЦИЈА КУЛТИВИСАНЕ ИМОВИНЕ (5245),0,0,0,0,0,0,0
БАТОЧИНА,433,УПОТРЕБА ДРАГОЦЕНОСТИ (5247),0,0,0,0,0,0,0
БАТОЧИНА,434,УПОТРЕБА ПРИРОДНЕ ИМОВИНЕ (од 5249 до 5251),0,0,0,0,0,0,0
БАТОЧИНА,435,АМОРТИЗАЦИЈА НЕМАТЕРИЈАЛНЕ ИМОВИНЕ (5253),0,0,0,0,0,0,0
БАТОЧИНА,441,ОТПЛАТЕ ДОМАЋИХ КАМАТА (од 5256 до 5264),0,0,3980,0,0,0,3980
БАТОЧИНА,442,ОТПЛАТА СТРАНИХ КАМАТА (од 5266 до 5271),0,0,0,0,0,0,0
БАТОЧИНА,443,ОТПЛАТА КАМАТА ПО ГАРАНЦИЈАМА (5273),0,0,0,0,0,0,0
БАТОЧИНА,444,ПРАТЕЋИ ТРОШКОВИ ЗАДУЖИВАЊА (од 5275 до 5277),0,0,2573,0,0,0,2573
БАТОЧИНА,451,СУБВЕНЦИЈЕ ЈАВНИМ НЕФИНАНСИЈСКИМ ПРЕДУЗЕЋИМА И ОРГАНИЗАЦИЈАМА (5280 + 5281),0,0,0,0,0,0,0
БАТОЧИНА,452,СУБВЕНЦИЈЕ ПРИВАТНИМ ФИНАНСИЈСКИМ ИНСТИТУЦИЈАМА (5283 + 5284),0,0,0,0,0,0,0
БАТОЧИНА,453,СУБВЕНЦИЈЕ ЈАВНИМ ФИНАНСИЈСКИМ ИНСТИТУЦИЈАМА (5286 + 5287),0,0,0,0,0,0,0
БАТОЧИНА,454,СУБВЕНЦИЈЕ ПРИВАТНИМ ПРЕДУЗЕЋИМА (5289 + 5290),0,0,0,0,0,0,0
БАТОЧИНА,461,ДОНАЦИЈЕ СТРАНИМ ВЛАДАМА (5293 + 5294),0,0,0,0,0,0,0
БАТОЧИНА,462,ДОТАЦИЈЕ МЕЂУНАРОДНИМ ОРГАНИЗАЦИЈАМА (5296 + 5297),0,0,0,0,0,0,0
БАТОЧИНА,463,ТРАНСФЕРИ ОСТАЛИМ НИВОИМА ВЛАСТИ (5299 + 5300),464,0,14125,0,0,0,14589
БАТОЧИНА,464,ДОТАЦИЈЕ ОРГАНИЗАЦИЈАМА ОБАВЕЗНОГ СОЦИЈАЛНОГ ОСИГУРАЊА (5302 + 5303),0,0,0,0,0,0,0
БАТОЧИНА,465,ОСТАЛЕ ДОТАЦИЈЕ И ТРАНСФЕРИ (5305 + 5306),0,0,0,0,0,0,0
БАТОЧИНА,471,ПРАВА ИЗ СОЦИЈАЛНОГ ОСИГУРАЊА (ОРГАНИЗАЦИЈЕ ОБАВЕЗНОГ СОЦИЈАЛНОГ ОСИГУРАЊА) (од 5309 до 5311),0,0,0,0,0,0,0
БАТОЧИНА,472,НАКНАДЕ ЗА СОЦИЈАЛНУ ЗАШТИТУ ИЗ БУЏЕТА (од 5313 до 5321),0,0,1204,0,0,0,1204
БАТОЧИНА,481,ДОТАЦИЈЕ НЕВЛАДИНИМ ОРГАНИЗАЦИЈАМА (5324 + 5325),0,0,16327,0,0,1502,17829
БАТОЧИНА,482,"ПОРЕЗИ, ОБАВЕЗНЕ ТАКСЕ И КАЗНЕ (од 5327 до 5329)",6,0,307,0,0,78,391
БАТОЧИНА,483,НОВЧАНЕ КАЗНЕ И ПЕНАЛИ ПО РЕШЕЊУ СУДОВА (5331),0,0,54,0,0,15,69
БАТОЧИНА,484,НАКНАДА ШТЕТЕ ЗА ПОВРЕДЕ ИЛИ ШТЕТУ НАСТАЛУ УСЛЕД ЕЛЕМЕНТАРНИХ НЕПОГОДА ИЛИ ДРУГИХ ПРИРОДНИХ УЗРОКА (5333 + 5334),0,0,0,0,0,0,0
БАТОЧИНА,485,НАКНАДА ШТЕТЕ ЗА ПОВРЕДЕ ИЛИ ШТЕТУ НАНЕТУ ОД СТРАНЕ ДРЖАВНИХ ОРГАНА (5336),0,0,100,0,0,0,100
БАТОЧИНА,489,РАСХОДИ КОЈИ СЕ ФИНАНСИРАЈУ ИЗ СРЕДСТАВА ЗА РЕАЛИЗАЦИЈУ НАЦИОНАЛНОГ ИНВЕСТИЦИОНОГ ПЛАНА (5338),0,0,0,0,0,0,0
БАТОЧИНА,511,ЗГРАДЕ И ГРАЂЕВИНСКИ ОБЈЕКТИ (од 5342 до 5345),4906,0,12217,0,1598,326,19047
БАТОЧИНА,512,МАШИНЕ И ОПРЕМА (од 5347 до 5355),592,0,2145,0,1219,407,4363
БАТОЧИНА,513,ОСТАЛЕ НЕКРЕТНИНЕ И ОПРЕМА (5357),0,0,0,0,0,0,0
БАТОЧИНА,514,КУЛТИВИСАНА ИМОВИНА (5359),0,0,0,0,0,0,0
БАТОЧИНА,515,НЕМАТЕРИЈАЛНА ИМОВИНА (5361),0,0,100,0,0,92,192
БАТОЧИНА,521,РОБНЕ РЕЗЕРВЕ (5364),0,0,0,0,0,0,0
БАТОЧИНА,522,ЗАЛИХЕ ПРОИЗВОДЊЕ (од 5366 до 5368),0,0,0,0,0,0,0
БАТОЧИНА,523,ЗАЛИХЕ РОБЕ ЗА ДАЉУ ПРОДАЈУ (5370),0,0,0,0,0,0,0
БАТОЧИНА,531,ДРАГОЦЕНОСТИ (5373),0,0,0,0,0,0,0
БАТОЧИНА,541,ЗЕМЉИШТЕ (5376),0,0,210,0,0,0,210
БАТОЧИНА,542,РУДНА БОГАТСТВА (5378),0,0,0,0,0,0,0
БАТОЧИНА,543,ШУМЕ И ВОДЕ (5380 + 5381),0,0,0,0,0,0,0
БАТОЧИНА,551,НЕФИНАНСИЈСКА ИМОВИНА КОЈА СЕ ФИНАНСИРА ИЗ СРЕДСТАВА ЗА РЕАЛИЗАЦИЈУ НАЦИОНАЛНОГ ИНВЕСТИЦИОНОГ ПЛАНА (5384),0,0,0,0,0,0,0
БАТОЧИНА,611,ОТПЛАТА ГЛАВНИЦЕ ДОМАЋИМ КРЕДИТОРИМА (од 5388 до 5396),0,0,6303,0,0,0,6303
БАТОЧИНА,612,ОТПЛАТА ГЛАВНИЦЕ СТРАНИМ КРЕДИТОРИМА (од 5398 до 5404),0,0,0,0,0,0,0
БАТОЧИНА,613,ОТПЛАТА ГЛАВНИЦЕ ПО ГАРАНЦИЈАМА (5406),0,0,0,0,0,0,0
БАТОЧИНА,614,ОТПЛАТА ГЛАВНИЦЕ ЗА ФИНАНСИЈСКИ ЛИЗИНГ (5408),0,0,0,0,0,0,0
БАТОЧИНА,621,НАБАВКА ДОМАЋЕ ФИНАНСИЈСКЕ ИМОВИНЕ (од 5411 до 5419),0,0,0,0,0,0,0
БАТОЧИНА,622,НАБАВКА СТРАНЕ ФИНАНСИЈСКЕ ИМОВИНЕ (од 5421 до 5428),0,0,0,0,0,0,0
БАТОЧИНА,623,НАБАВКА ФИНАНСИЈСКЕ ИМОВИНЕ КОЈА СЕ ФИНАНСИРА ИЗ СРЕДСТАВА ЗА РЕАЛИЗАЦИЈУ НАЦИОНАЛНОГ ИНВЕСТИЦИОНОГ ПЛАНА (5430),0,0,0,0,0,0,0
БАЈИНА БАШТА,411,"ПЛАТЕ, ДОДАЦИ И НАКНАДЕ ЗАПОСЛЕНИХ (ЗАРАДЕ) (5174)",6282,0,69423,0,0,49333,125038
БАЈИНА БАШТА,412,СОЦИЈАЛНИ ДОПРИНОСИ НА ТЕРЕТ ПОСЛОДАВЦА (од 5176 до 5178),0,0,12425,0,0,9703,22128
БАЈИНА БАШТА,413,НАКНАДЕ У НАТУРИ (5180),0,0,326,0,0,22,348
БАЈИНА БАШТА,414,СОЦИЈАЛНА ДАВАЊА ЗАПОСЛЕНИМА (од 5182 до 5185),851,0,3121,0,0,1439,5411
БАЈИНА БАШТА,415,НАКНАДА ТРОШКОВА ЗА ЗАПОСЛЕНЕ (5187),0,0,21,0,0,1762,1783
БАЈИНА БАШТА,416,НАГРАДЕ ЗАПОСЛЕНИМА И ОСТАЛИ ПОСЕБНИ РАСХОДИ (5189),0,0,0,0,0,148,148
БАЈИНА БАШТА,417,ПОСЛАНИЧКИ ДОДАТАК (5191),0,0,0,0,0,0,0
БАЈИНА БАШТА,418,СУДИЈСКИ ДОДАТАК (5193),0,0,0,0,0,0,0
БАЈИНА БАШТА,421,СТАЛНИ ТРОШКОВИ (од 5196 до 5202),0,0,28931,0,0,20195,49126
БАЈИНА БАШТА,422,ТРОШКОВИ ПУТОВАЊА (од 5204 до 5208),0,0,2999,0,0,1077,4076
БАЈИНА БАШТА,423,УСЛУГЕ ПО УГОВОРУ (од 5210 до 5217),0,0,30185,0,50,30863,61098
БАЈИНА БАШТА,424,СПЕЦИЈАЛИЗОВАНЕ УСЛУГЕ (од 5219 до 5225),0,0,28752,0,0,3704,32456
БАЈИНА БАШТА,425,ТЕКУЋЕ ПОПРАВКЕ И ОДРЖАВАЊЕ (5227 + 5228),0,0,76318,0,0,10017,86335
БАЈИНА БАШТА,426,МАТЕРИЈАЛ (од 5230 до 5238),0,0,10645,0,11,44888,55544
БАЈИНА БАШТА,431,АМОРТИЗАЦИЈА НЕКРЕТНИНА И ОПРЕМЕ (од 5241 до 5243),0,0,0,0,0,8495,8495
БАЈИНА БАШТА,432,АМОРТИЗАЦИЈА КУЛТИВИСАНЕ ИМОВИНЕ (5245),0,0,0,0,0,0,0
БАЈИНА БАШТА,433,УПОТРЕБА ДРАГОЦЕНОСТИ (5247),0,0,0,0,0,0,0
БАЈИНА БАШТА,434,УПОТРЕБА ПРИРОДНЕ ИМОВИНЕ (од 5249 до 5251),0,0,0,0,0,0,0
БАЈИНА БАШТА,435,АМОРТИЗАЦИЈА НЕМАТЕРИЈАЛНЕ ИМОВИНЕ (5253),0,0,0,0,0,0,0
БАЈИНА БАШТА,441,ОТПЛАТЕ ДОМАЋИХ КАМАТА (од 5256 до 5264),0,0,4179,0,0,3043,7222
БАЈИНА БАШТА,442,ОТПЛАТА СТРАНИХ КАМАТА (од 5266 до 5271),0,0,0,0,0,0,0
БАЈИНА БАШТА,443,ОТПЛАТА КАМАТА ПО ГАРАНЦИЈАМА (5273),0,0,0,0,0,0,0
БАЈИНА БАШТА,444,ПРАТЕЋИ ТРОШКОВИ ЗАДУЖИВАЊА (од 5275 до 5277),0,0,269,0,0,338,607
БАЈИНА БАШТА,451,СУБВЕНЦИЈЕ ЈАВНИМ НЕФИНАНСИЈСКИМ ПРЕДУЗЕЋИМА И ОРГАНИЗАЦИЈАМА (5280 + 5281),0,0,69851,0,0,937,70788
БАЈИНА БАШТА,452,СУБВЕНЦИЈЕ ПРИВАТНИМ ФИНАНСИЈСКИМ ИНСТИТУЦИЈАМА (5283 + 5284),0,0,0,0,0,0,0
БАЈИНА БАШТА,453,СУБВЕНЦИЈЕ ЈАВНИМ ФИНАНСИЈСКИМ ИНСТИТУЦИЈАМА (5286 + 5287),0,0,0,0,0,0,0
БАЈИНА БАШТА,454,СУБВЕНЦИЈЕ ПРИВАТНИМ ПРЕДУЗЕЋИМА (5289 + 5290),0,0,0,0,0,0,0
БАЈИНА БАШТА,461,ДОНАЦИЈЕ СТРАНИМ ВЛАДАМА (5293 + 5294),0,0,0,0,0,0,0
БАЈИНА БАШТА,462,ДОТАЦИЈЕ МЕЂУНАРОДНИМ ОРГАНИЗАЦИЈАМА (5296 + 5297),0,0,0,0,0,0,0
БАЈИНА БАШТА,463,ТРАНСФЕРИ ОСТАЛИМ НИВОИМА ВЛАСТИ (5299 + 5300),0,0,79809,0,0,0,79809
БАЈИНА БАШТА,464,ДОТАЦИЈЕ ОРГАНИЗАЦИЈАМА ОБАВЕЗНОГ СОЦИЈАЛНОГ ОСИГУРАЊА (5302 + 5303),0,0,0,0,0,0,0
БАЈИНА БАШТА,465,ОСТАЛЕ ДОТАЦИЈЕ И ТРАНСФЕРИ (5305 + 5306),0,0,0,0,0,0,0
БАЈИНА БАШТА,471,ПРАВА ИЗ СОЦИЈАЛНОГ ОСИГУРАЊА (ОРГАНИЗАЦИЈЕ ОБАВЕЗНОГ СОЦИЈАЛНОГ ОСИГУРАЊА) (од 5309 до 5311),0,0,0,0,0,0,0
БАЈИНА БАШТА,472,НАКНАДЕ ЗА СОЦИЈАЛНУ ЗАШТИТУ ИЗ БУЏЕТА (од 5313 до 5321),0,0,4010,0,0,238,4248
БАЈИНА БАШТА,481,ДОТАЦИЈЕ НЕВЛАДИНИМ ОРГАНИЗАЦИЈАМА (5324 + 5325),1000,0,22748,0,320,2237,26305
БАЈИНА БАШТА,482,"ПОРЕЗИ, ОБАВЕЗНЕ ТАКСЕ И КАЗНЕ (од 5327 до 5329)",0,0,397,0,0,1579,1976
БАЈИНА БАШТА,483,НОВЧАНЕ КАЗНЕ И ПЕНАЛИ ПО РЕШЕЊУ СУДОВА (5331),0,0,0,0,0,88,88
БАЈИНА БАШТА,484,НАКНАДА ШТЕТЕ ЗА ПОВРЕДЕ ИЛИ ШТЕТУ НАСТАЛУ УСЛЕД ЕЛЕМЕНТАРНИХ НЕПОГОДА ИЛИ ДРУГИХ ПРИРОДНИХ УЗРОКА (5333 + 5334),0,0,4252,0,0,0,4252
БАЈИНА БАШТА,485,НАКНАДА ШТЕТЕ ЗА ПОВРЕДЕ ИЛИ ШТЕТУ НАНЕТУ ОД СТРАНЕ ДРЖАВНИХ ОРГАНА (5336),0,0,0,0,0,565,565
БАЈИНА БАШТА,489,РАСХОДИ КОЈИ СЕ ФИНАНСИРАЈУ ИЗ СРЕДСТАВА ЗА РЕАЛИЗАЦИЈУ НАЦИОНАЛНОГ ИНВЕСТИЦИОНОГ ПЛАНА (5338),0,0,0,0,0,0,0
БАЈИНА БАШТА,511,ЗГРАДЕ И ГРАЂЕВИНСКИ ОБЈЕКТИ (од 5342 до 5345),0,0,166169,0,0,926,167095
БАЈИНА БАШТА,512,МАШИНЕ И ОПРЕМА (од 5347 до 5355),0,0,3371,0,0,3677,7048
БАЈИНА БАШТА,513,ОСТАЛЕ НЕКРЕТНИНЕ И ОПРЕМА (5357),0,0,0,0,0,47,47
БАЈИНА БАШТА,514,КУЛТИВИСАНА ИМОВИНА (5359),0,0,0,0,0,0,0
БАЈИНА БАШТА,515,НЕМАТЕРИЈАЛНА ИМОВИНА (5361),0,0,925,0,0,169,1094
БАЈИНА БАШТА,521,РОБНЕ РЕЗЕРВЕ (5364),0,0,0,0,0,0,0
БАЈИНА БАШТА,522,ЗАЛИХЕ ПРОИЗВОДЊЕ (од 5366 до 5368),0,0,0,0,0,31163,31163
БАЈИНА БАШТА,523,ЗАЛИХЕ РОБЕ ЗА ДАЉУ ПРОДАЈУ (5370),0,0,0,0,0,0,0
БАЈИНА БАШТА,531,ДРАГОЦЕНОСТИ (5373),0,0,0,0,0,0,0
БАЈИНА БАШТА,541,ЗЕМЉИШТЕ (5376),0,0,7531,0,0,475,8006
БАЈИНА БАШТА,542,РУДНА БОГАТСТВА (5378),0,0,0,0,0,0,0
БАЈИНА БАШТА,543,ШУМЕ И ВОДЕ (5380 + 5381),0,0,0,0,0,0,0
БАЈИНА БАШТА,551,НЕФИНАНСИЈСКА ИМОВИНА КОЈА СЕ ФИНАНСИРА ИЗ СРЕДСТАВА ЗА РЕАЛИЗАЦИЈУ НАЦИОНАЛНОГ ИНВЕСТИЦИОНОГ ПЛАНА (5384),0,0,0,0,0,0,0
БАЈИНА БАШТА,611,ОТПЛАТА ГЛАВНИЦЕ ДОМАЋИМ КРЕДИТОРИМА (од 5388 до 5396),0,0,0,0,0,0,0
БАЈИНА БАШТА,612,ОТПЛАТА ГЛАВНИЦЕ СТРАНИМ КРЕДИТОРИМА (од 5398 до 5404),0,0,0,0,0,0,0
БАЈИНА БАШТА,613,ОТПЛАТА ГЛАВНИЦЕ ПО ГАРАНЦИЈАМА (5406),0,0,0,0,0,0,0
БАЈИНА БАШТА,614,ОТПЛАТА ГЛАВНИЦЕ ЗА ФИНАНСИЈСКИ ЛИЗИНГ (5408),0,0,0,0,0,0,0
БАЈИНА БАШТА,621,НАБАВКА ДОМАЋЕ ФИНАНСИЈСКЕ ИМОВИНЕ (од 5411 до 5419),0,0,0,0,0,0,0
БАЈИНА БАШТА,622,НАБАВКА СТРАНЕ ФИНАНСИЈСКЕ ИМОВИНЕ (од 5421 до 5428),0,0,0,0,0,0,0
БАЈИНА БАШТА,623,НАБАВКА ФИНАНСИЈСКЕ ИМОВИНЕ КОЈА СЕ ФИНАНСИРА ИЗ СРЕДСТАВА ЗА РЕАЛИЗАЦИЈУ НАЦИОНАЛНОГ ИНВЕСТИЦИОНОГ ПЛАНА (5430),0,0,0,0,0,0,0
БЛАЦЕ,411,"ПЛАТЕ, ДОДАЦИ И НАКНАДЕ ЗАПОСЛЕНИХ (ЗАРАДЕ) (5174)",2509,0,40936,0,0,4127,47572
БЛАЦЕ,412,СОЦИЈАЛНИ ДОПРИНОСИ НА ТЕРЕТ ПОСЛОДАВЦА (од 5176 до 5178),452,0,7326,0,0,745,8523
БЛАЦЕ,413,НАКНАДЕ У НАТУРИ (5180),0,0,0,0,0,0,0
БЛАЦЕ,414,СОЦИЈАЛНА ДАВАЊА ЗАПОСЛЕНИМА (од 5182 до 5185),490,0,1325,0,0,438,2253
БЛАЦЕ,415,НАКНАДА ТРОШКОВА ЗА ЗАПОСЛЕНЕ (5187),0,0,1900,0,0,410,2310
БЛАЦЕ,416,НАГРАДЕ ЗАПОСЛЕНИМА И ОСТАЛИ ПОСЕБНИ РАСХОДИ (5189),0,0,423,0,0,0,423
БЛАЦЕ,417,ПОСЛАНИЧКИ ДОДАТАК (5191),0,0,0,0,0,0,0
БЛАЦЕ,418,СУДИЈСКИ ДОДАТАК (5193),0,0,0,0,0,0,0
БЛАЦЕ,421,СТАЛНИ ТРОШКОВИ (од 5196 до 5202),0,0,12622,0,0,3673,16295
БЛАЦЕ,422,ТРОШКОВИ ПУТОВАЊА (од 5204 до 5208),0,0,174,0,0,75,249
БЛАЦЕ,423,УСЛУГЕ ПО УГОВОРУ (од 5210 до 5217),0,0,5107,0,0,1092,6199
БЛАЦЕ,424,СПЕЦИЈАЛИЗОВАНЕ УСЛУГЕ (од 5219 до 5225),0,0,8797,0,0,727,9524
БЛАЦЕ,425,ТЕКУЋЕ ПОПРАВКЕ И ОДРЖАВАЊЕ (5227 + 5228),700,0,3847,0,0,1956,6503
БЛАЦЕ,426,МАТЕРИЈАЛ (од 5230 до 5238),82,0,2154,0,0,2283,4519
БЛАЦЕ,431,АМОРТИЗАЦИЈА НЕКРЕТНИНА И ОПРЕМЕ (од 5241 до 5243),0,0,0,0,0,112,112
БЛАЦЕ,432,АМОРТИЗАЦИЈА КУЛТИВИСАНЕ ИМОВИНЕ (5245),0,0,0,0,0,0,0
БЛАЦЕ,433,УПОТРЕБА ДРАГОЦЕНОСТИ (5247),0,0,0,0,0,0,0
БЛАЦЕ,434,УПОТРЕБА ПРИРОДНЕ ИМОВИНЕ (од 5249 до 5251),0,0,0,0,0,0,0
БЛАЦЕ,435,АМОРТИЗАЦИЈА НЕМАТЕРИЈАЛНЕ ИМОВИНЕ (5253),0,0,0,0,0,0,0
БЛАЦЕ,441,ОТПЛАТЕ ДОМАЋИХ КАМАТА (од 5256 до 5264),0,0,0,0,0,0,0
БЛАЦЕ,442,ОТПЛАТА СТРАНИХ КАМАТА (од 5266 до 5271),0,0,0,0,0,0,0
БЛАЦЕ,443,ОТПЛАТА КАМАТА ПО ГАРАНЦИЈАМА (5273),0,0,0,0,0,0,0
БЛАЦЕ,444,ПРАТЕЋИ ТРОШКОВИ ЗАДУЖИВАЊА (од 5275 до 5277),0,0,0,0,0,0,0
БЛАЦЕ,451,СУБВЕНЦИЈЕ ЈАВНИМ НЕФИНАНСИЈСКИМ ПРЕДУЗЕЋИМА И ОРГАНИЗАЦИЈАМА (5280 + 5281),0,0,44902,0,0,0,44902
БЛАЦЕ,452,СУБВЕНЦИЈЕ ПРИВАТНИМ ФИНАНСИЈСКИМ ИНСТИТУЦИЈАМА (5283 + 5284),0,0,0,0,0,0,0
БЛАЦЕ,453,СУБВЕНЦИЈЕ ЈАВНИМ ФИНАНСИЈСКИМ ИНСТИТУЦИЈАМА (5286 + 5287),0,0,0,0,0,0,0
БЛАЦЕ,454,СУБВЕНЦИЈЕ ПРИВАТНИМ ПРЕДУЗЕЋИМА (5289 + 5290),0,0,0,0,0,0,0
БЛАЦЕ,461,ДОНАЦИЈЕ СТРАНИМ ВЛАДАМА (5293 + 5294),0,0,0,0,0,0,0
БЛАЦЕ,462,ДОТАЦИЈЕ МЕЂУНАРОДНИМ ОРГАНИЗАЦИЈАМА (5296 + 5297),0,0,0,0,0,0,0
БЛАЦЕ,463,ТРАНСФЕРИ ОСТАЛИМ НИВОИМА ВЛАСТИ (5299 + 5300),0,0,758,0,0,0,758
БЛАЦЕ,464,ДОТАЦИЈЕ ОРГАНИЗАЦИЈАМА ОБАВЕЗНОГ СОЦИЈАЛНОГ ОСИГУРАЊА (5302 + 5303),0,0,0,0,0,0,0
БЛАЦЕ,465,ОСТАЛЕ ДОТАЦИЈЕ И ТРАНСФЕРИ (5305 + 5306),0,0,0,0,0,6,6
БЛАЦЕ,471,ПРАВА ИЗ СОЦИЈАЛНОГ ОСИГУРАЊА (ОРГАНИЗАЦИЈЕ ОБАВЕЗНОГ СОЦИЈАЛНОГ ОСИГУРАЊА) (од 5309 до 5311),0,0,0,0,0,0,0
БЛАЦЕ,472,НАКНАДЕ ЗА СОЦИЈАЛНУ ЗАШТИТУ ИЗ БУЏЕТА (од 5313 до 5321),0,0,3939,0,0,0,3939
БЛАЦЕ,481,ДОТАЦИЈЕ НЕВЛАДИНИМ ОРГАНИЗАЦИЈАМА (5324 + 5325),0,0,5675,0,0,0,5675
БЛАЦЕ,482,"ПОРЕЗИ, ОБАВЕЗНЕ ТАКСЕ И КАЗНЕ (од 5327 до 5329)",0,0,11,0,0,45,56
БЛАЦЕ,483,НОВЧАНЕ КАЗНЕ И ПЕНАЛИ ПО РЕШЕЊУ СУДОВА (5331),0,0,28,0,0,9,37
БЛАЦЕ,484,НАКНАДА ШТЕТЕ ЗА ПОВРЕДЕ ИЛИ ШТЕТУ НАСТАЛУ УСЛЕД ЕЛЕМЕНТАРНИХ НЕПОГОДА ИЛИ ДРУГИХ ПРИРОДНИХ УЗРОКА (5333 + 5334),0,0,670,0,0,0,670
БЛАЦЕ,485,НАКНАДА ШТЕТЕ ЗА ПОВРЕДЕ ИЛИ ШТЕТУ НАНЕТУ ОД СТРАНЕ ДРЖАВНИХ ОРГАНА (5336),0,0,900,0,0,0,900
БЛАЦЕ,489,РАСХОДИ КОЈИ СЕ ФИНАНСИРАЈУ ИЗ СРЕДСТАВА ЗА РЕАЛИЗАЦИЈУ НАЦИОНАЛНОГ ИНВЕСТИЦИОНОГ ПЛАНА (5338),0,0,0,0,0,0,0
БЛАЦЕ,511,ЗГРАДЕ И ГРАЂЕВИНСКИ ОБЈЕКТИ (од 5342 до 5345),19628,0,37197,0,0,1267,58092
БЛАЦЕ,512,МАШИНЕ И ОПРЕМА (од 5347 до 5355),0,0,1738,0,0,116,1854
БЛАЦЕ,513,ОСТАЛЕ НЕКРЕТНИНЕ И ОПРЕМА (5357),0,0,0,0,0,0,0
БЛАЦЕ,514,КУЛТИВИСАНА ИМОВИНА (5359),0,0,0,0,0,0,0
БЛАЦЕ,515,НЕМАТЕРИЈАЛНА ИМОВИНА (5361),0,0,108,0,0,85,193
БЛАЦЕ,521,РОБНЕ РЕЗЕРВЕ (5364),0,0,0,0,0,0,0
БЛАЦЕ,522,ЗАЛИХЕ ПРОИЗВОДЊЕ (од 5366 до 5368),0,0,0,0,0,0,0
БЛАЦЕ,523,ЗАЛИХЕ РОБЕ ЗА ДАЉУ ПРОДАЈУ (5370),0,0,0,0,0,156,156
БЛАЦЕ,531,ДРАГОЦЕНОСТИ (5373),0,0,0,0,0,0,0
БЛАЦЕ,541,ЗЕМЉИШТЕ (5376),0,0,0,0,0,0,0
БЛАЦЕ,542,РУДНА БОГАТСТВА (5378),0,0,0,0,0,0,0
БЛАЦЕ,543,ШУМЕ И ВОДЕ (5380 + 5381),0,0,0,0,0,0,0
БЛАЦЕ,551,НЕФИНАНСИЈСКА ИМОВИНА КОЈА СЕ ФИНАНСИРА ИЗ СРЕДСТАВА ЗА РЕАЛИЗАЦИЈУ НАЦИОНАЛНОГ ИНВЕСТИЦИОНОГ ПЛАНА (5384),0,0,0,0,0,0,0
БЛАЦЕ,611,ОТПЛАТА ГЛАВНИЦЕ ДОМАЋИМ КРЕДИТОРИМА (од 5388 до 5396),0,0,0,0,0,0,0
БЛАЦЕ,612,ОТПЛАТА ГЛАВНИЦЕ СТРАНИМ КРЕДИТОРИМА (од 5398 до 5404),0,0,0,0,0,0,0
БЛАЦЕ,613,ОТПЛАТА ГЛАВНИЦЕ ПО ГАРАНЦИЈАМА (5406),0,0,0,0,0,0,0
БЛАЦЕ,614,ОТПЛАТА ГЛАВНИЦЕ ЗА ФИНАНСИЈСКИ ЛИЗИНГ (5408),0,0,0,0,0,0,0
БЛАЦЕ,621,НАБАВКА ДОМАЋЕ ФИНАНСИЈСКЕ ИМОВИНЕ (од 5411 до 5419),0,0,0,0,0,0,0
БЛАЦЕ,622,НАБАВКА СТРАНЕ ФИНАНСИЈСКЕ ИМОВИНЕ (од 5421 до 5428),0,0,0,0,0,0,0
БЛАЦЕ,623,НАБАВКА ФИНАНСИЈСКЕ ИМОВИНЕ КОЈА СЕ ФИНАНСИРА ИЗ СРЕДСТАВА ЗА РЕАЛИЗАЦИЈУ НАЦИОНАЛНОГ ИНВЕСТИЦИОНОГ ПЛАНА (5430),0,0,0,0,0,0,0
БАБУШНИЦА,411,"ПЛАТЕ, ДОДАЦИ И НАКНАДЕ ЗАПОСЛЕНИХ (ЗАРАДЕ) (5174)",98,0,47917,0,0,1176,49191
БАБУШНИЦА,412,СОЦИЈАЛНИ ДОПРИНОСИ НА ТЕРЕТ ПОСЛОДАВЦА (од 5176 до 5178),18,0,8577,0,0,221,8816
БАБУШНИЦА,413,НАКНАДЕ У НАТУРИ (5180),0,0,61,0,0,0,61
БАБУШНИЦА,414,СОЦИЈАЛНА ДАВАЊА ЗАПОСЛЕНИМА (од 5182 до 5185),0,0,14684,0,0,822,15506
БАБУШНИЦА,415,НАКНАДА ТРОШКОВА ЗА ЗАПОСЛЕНЕ (5187),0,0,1961,0,0,11,1972
БАБУШНИЦА,416,НАГРАДЕ ЗАПОСЛЕНИМА И ОСТАЛИ ПОСЕБНИ РАСХОДИ (5189),0,0,0,0,0,0,0
БАБУШНИЦА,417,ПОСЛАНИЧКИ ДОДАТАК (5191),0,0,980,0,0,0,980
БАБУШНИЦА,418,СУДИЈСКИ ДОДАТАК (5193),0,0,0,0,0,0,0
БАБУШНИЦА,421,СТАЛНИ ТРОШКОВИ (од 5196 до 5202),2,0,9898,0,77,1261,11238
БАБУШНИЦА,422,ТРОШКОВИ ПУТОВАЊА (од 5204 до 5208),0,0,1768,0,0,149,1917
БАБУШНИЦА,423,УСЛУГЕ ПО УГОВОРУ (од 5210 до 5217),0,0,19949,0,144,669,20762
БАБУШНИЦА,424,СПЕЦИЈАЛИЗОВАНЕ УСЛУГЕ (од 5219 до 5225),0,0,3589,0,0,162,3751
БАБУШНИЦА,425,ТЕКУЋЕ ПОПРАВКЕ И ОДРЖАВАЊЕ (5227 + 5228),0,0,6397,0,0,703,7100
БАБУШНИЦА,426,МАТЕРИЈАЛ (од 5230 до 5238),3,0,5681,0,23,2812,8519
БАБУШНИЦА,431,АМОРТИЗАЦИЈА НЕКРЕТНИНА И ОПРЕМЕ (од 5241 до 5243),0,0,0,0,0,0,0
БАБУШНИЦА,432,АМОРТИЗАЦИЈА КУЛТИВИСАНЕ ИМОВИНЕ (5245),0,0,0,0,0,0,0
БАБУШНИЦА,433,УПОТРЕБА ДРАГОЦЕНОСТИ (5247),0,0,0,0,0,0,0
БАБУШНИЦА,434,УПОТРЕБА ПРИРОДНЕ ИМОВИНЕ (од 5249 до 5251),0,0,0,0,0,0,0
БАБУШНИЦА,435,АМОРТИЗАЦИЈА НЕМАТЕРИЈАЛНЕ ИМОВИНЕ (5253),0,0,0,0,0,0,0
БАБУШНИЦА,441,ОТПЛАТЕ ДОМАЋИХ КАМАТА (од 5256 до 5264),0,0,0,0,0,0,0
БАБУШНИЦА,442,ОТПЛАТА СТРАНИХ КАМАТА (од 5266 до 5271),0,0,0,0,0,0,0
БАБУШНИЦА,443,ОТПЛАТА КАМАТА ПО ГАРАНЦИЈАМА (5273),0,0,0,0,0,0,0
БАБУШНИЦА,444,ПРАТЕЋИ ТРОШКОВИ ЗАДУЖИВАЊА (од 5275 до 5277),0,0,0,0,0,0,0
БАБУШНИЦА,451,СУБВЕНЦИЈЕ ЈАВНИМ НЕФИНАНСИЈСКИМ ПРЕДУЗЕЋИМА И ОРГАНИЗАЦИЈАМА (5280 + 5281),0,0,7736,0,0,0,7736
БАБУШНИЦА,452,СУБВЕНЦИЈЕ ПРИВАТНИМ ФИНАНСИЈСКИМ ИНСТИТУЦИЈАМА (5283 + 5284),0,0,0,0,0,0,0
БАБУШНИЦА,453,СУБВЕНЦИЈЕ ЈАВНИМ ФИНАНСИЈСКИМ ИНСТИТУЦИЈАМА (5286 + 5287),0,0,0,0,0,0,0
БАБУШНИЦА,454,СУБВЕНЦИЈЕ ПРИВАТНИМ ПРЕДУЗЕЋИМА (5289 + 5290),0,0,0,0,0,0,0
БАБУШНИЦА,461,ДОНАЦИЈЕ СТРАНИМ ВЛАДАМА (5293 + 5294),0,0,0,0,0,0,0
БАБУШНИЦА,462,ДОТАЦИЈЕ МЕЂУНАРОДНИМ ОРГАНИЗАЦИЈАМА (5296 + 5297),0,0,0,0,0,0,0
БАБУШНИЦА,463,ТРАНСФЕРИ ОСТАЛИМ НИВОИМА ВЛАСТИ (5299 + 5300),0,0,20199,0,0,0,20199
БАБУШНИЦА,464,ДОТАЦИЈЕ ОРГАНИЗАЦИЈАМА ОБАВЕЗНОГ СОЦИЈАЛНОГ ОСИГУРАЊА (5302 + 5303),0,0,0,0,0,0,0
БАБУШНИЦА,465,ОСТАЛЕ ДОТАЦИЈЕ И ТРАНСФЕРИ (5305 + 5306),0,0,2607,0,0,0,2607
БАБУШНИЦА,471,ПРАВА ИЗ СОЦИЈАЛНОГ ОСИГУРАЊА (ОРГАНИЗАЦИЈЕ ОБАВЕЗНОГ СОЦИЈАЛНОГ ОСИГУРАЊА) (од 5309 до 5311),0,0,0,0,0,0,0
БАБУШНИЦА,472,НАКНАДЕ ЗА СОЦИЈАЛНУ ЗАШТИТУ ИЗ БУЏЕТА (од 5313 до 5321),0,0,5905,0,0,0,5905
БАБУШНИЦА,481,ДОТАЦИЈЕ НЕВЛАДИНИМ ОРГАНИЗАЦИЈАМА (5324 + 5325),0,0,6323,0,0,0,6323
БАБУШНИЦА,482,"ПОРЕЗИ, ОБАВЕЗНЕ ТАКСЕ И КАЗНЕ (од 5327 до 5329)",0,0,220,0,0,52,272
БАБУШНИЦА,483,НОВЧАНЕ КАЗНЕ И ПЕНАЛИ ПО РЕШЕЊУ СУДОВА (5331),0,0,1689,0,0,0,1689
БАБУШНИЦА,484,НАКНАДА ШТЕТЕ ЗА ПОВРЕДЕ ИЛИ ШТЕТУ НАСТАЛУ УСЛЕД ЕЛЕМЕНТАРНИХ НЕПОГОДА ИЛИ ДРУГИХ ПРИРОДНИХ УЗРОКА (5333 + 5334),0,0,424,0,0,0,424
БАБУШНИЦА,485,НАКНАДА ШТЕТЕ ЗА ПОВРЕДЕ ИЛИ ШТЕТУ НАНЕТУ ОД СТРАНЕ ДРЖАВНИХ ОРГАНА (5336),0,0,0,0,0,0,0
БАБУШНИЦА,489,РАСХОДИ КОЈИ СЕ ФИНАНСИРАЈУ ИЗ СРЕДСТАВА ЗА РЕАЛИЗАЦИЈУ НАЦИОНАЛНОГ ИНВЕСТИЦИОНОГ ПЛАНА (5338),0,0,5,0,0,20,25
БАБУШНИЦА,511,ЗГРАДЕ И ГРАЂЕВИНСКИ ОБЈЕКТИ (од 5342 до 5345),0,0,11015,0,0,799,11814
БАБУШНИЦА,512,МАШИНЕ И ОПРЕМА (од 5347 до 5355),0,0,874,0,1943,24,2841
БАБУШНИЦА,513,ОСТАЛЕ НЕКРЕТНИНЕ И ОПРЕМА (5357),0,0,0,0,0,0,0
БАБУШНИЦА,514,КУЛТИВИСАНА ИМОВИНА (5359),0,0,0,0,0,0,0
БАБУШНИЦА,515,НЕМАТЕРИЈАЛНА ИМОВИНА (5361),0,0,45,0,0,37,82
БАБУШНИЦА,521,РОБНЕ РЕЗЕРВЕ (5364),0,0,0,0,0,0,0
БАБУШНИЦА,522,ЗАЛИХЕ ПРОИЗВОДЊЕ (од 5366 до 5368),0,0,0,0,0,0,0
БАБУШНИЦА,523,ЗАЛИХЕ РОБЕ ЗА ДАЉУ ПРОДАЈУ (5370),0,0,0,0,0,0,0
БАБУШНИЦА,531,ДРАГОЦЕНОСТИ (5373),0,0,0,0,0,0,0
БАБУШНИЦА,541,ЗЕМЉИШТЕ (5376),0,0,65,0,0,0,65
БАБУШНИЦА,542,РУДНА БОГАТСТВА (5378),0,0,0,0,0,0,0
БАБУШНИЦА,543,ШУМЕ И ВОДЕ (5380 + 5381),0,0,0,0,0,0,0
БАБУШНИЦА,551,НЕФИНАНСИЈСКА ИМОВИНА КОЈА СЕ ФИНАНСИРА ИЗ СРЕДСТАВА ЗА РЕАЛИЗАЦИЈУ НАЦИОНАЛНОГ ИНВЕСТИЦИОНОГ ПЛАНА (5384),0,0,0,0,0,0,0
БАБУШНИЦА,611,ОТПЛАТА ГЛАВНИЦЕ ДОМАЋИМ КРЕДИТОРИМА (од 5388 до 5396),0,0,0,0,0,0,0
БАБУШНИЦА,612,ОТПЛАТА ГЛАВНИЦЕ СТРАНИМ КРЕДИТОРИМА (од 5398 до 5404),0,0,0,0,0,0,0
БАБУШНИЦА,613,ОТПЛАТА ГЛАВНИЦЕ ПО ГАРАНЦИЈАМА (5406),0,0,0,0,0,0,0
БАБУШНИЦА,614,ОТПЛАТА ГЛАВНИЦЕ ЗА ФИНАНСИЈСКИ ЛИЗИНГ (5408),0,0,0,0,0,0,0
БАБУШНИЦА,621,НАБАВКА ДОМАЋЕ ФИНАНСИЈСКЕ ИМОВИНЕ (од 5411 до 5419),0,0,0,0,0,0,0
БАБУШНИЦА,622,НАБАВКА СТРАНЕ ФИНАНСИЈСКЕ ИМОВИНЕ (од 5421 до 5428),0,0,0,0,0,0,0
БАБУШНИЦА,623,НАБАВКА ФИНАНСИЈСКЕ ИМОВИНЕ КОЈА СЕ ФИНАНСИРА ИЗ СРЕДСТАВА ЗА РЕАЛИЗАЦИЈУ НАЦИОНАЛНОГ ИНВЕСТИЦИОНОГ ПЛАНА (5430),0,0,0,0,0,0,0
ВРБАС,411,"ПЛАТЕ, ДОДАЦИ И НАКНАДЕ ЗАПОСЛЕНИХ (ЗАРАДЕ) (5174)",7852,0,230799,0,0,12148,250799
ВРБАС,412,СОЦИЈАЛНИ ДОПРИНОСИ НА ТЕРЕТ ПОСЛОДАВЦА (од 5176 до 5178),1428,0,41251,0,0,2149,44828
ВРБАС,413,НАКНАДЕ У НАТУРИ (5180),0,0,199,0,0,128,327
ВРБАС,414,СОЦИЈАЛНА ДАВАЊА ЗАПОСЛЕНИМА (од 5182 до 5185),2501,0,6471,737,0,5287,14996
ВРБАС,415,НАКНАДА ТРОШКОВА ЗА ЗАПОСЛЕНЕ (5187),0,0,2530,0,0,1098,3628
ВРБАС,416,НАГРАДЕ ЗАПОСЛЕНИМА И ОСТАЛИ ПОСЕБНИ РАСХОДИ (5189),0,0,100,0,0,82,182
ВРБАС,417,ПОСЛАНИЧКИ ДОДАТАК (5191),0,0,0,0,0,0,0
ВРБАС,418,СУДИЈСКИ ДОДАТАК (5193),0,0,0,0,0,0,0
ВРБАС,421,СТАЛНИ ТРОШКОВИ (од 5196 до 5202),454,0,74574,0,0,4287,79315
ВРБАС,422,ТРОШКОВИ ПУТОВАЊА (од 5204 до 5208),135,0,48213,0,0,1099,49447
ВРБАС,423,УСЛУГЕ ПО УГОВОРУ (од 5210 до 5217),257,270,41510,0,0,5013,47050
ВРБАС,424,СПЕЦИЈАЛИЗОВАНЕ УСЛУГЕ (од 5219 до 5225),1855,1969,61092,0,0,2572,67488
ВРБАС,425,ТЕКУЋЕ ПОПРАВКЕ И ОДРЖАВАЊЕ (5227 + 5228),624,1739,65661,0,0,3868,71892
ВРБАС,426,МАТЕРИЈАЛ (од 5230 до 5238),0,0,29439,0,0,2795,32234
ВРБАС,431,АМОРТИЗАЦИЈА НЕКРЕТНИНА И ОПРЕМЕ (од 5241 до 5243),0,0,0,0,0,1344,1344
ВРБАС,432,АМОРТИЗАЦИЈА КУЛТИВИСАНЕ ИМОВИНЕ (5245),0,0,0,0,0,0,0
ВРБАС,433,УПОТРЕБА ДРАГОЦЕНОСТИ (5247),0,0,0,0,0,0,0
ВРБАС,434,УПОТРЕБА ПРИРОДНЕ ИМОВИНЕ (од 5249 до 5251),0,0,0,0,0,0,0
ВРБАС,435,АМОРТИЗАЦИЈА НЕМАТЕРИЈАЛНЕ ИМОВИНЕ (5253),0,0,0,0,0,0,0
ВРБАС,441,ОТПЛАТЕ ДОМАЋИХ КАМАТА (од 5256 до 5264),0,0,18008,0,0,81,18089
ВРБАС,442,ОТПЛАТА СТРАНИХ КАМАТА (од 5266 до 5271),0,0,0,0,0,0,0
ВРБАС,443,ОТПЛАТА КАМАТА ПО ГАРАНЦИЈАМА (5273),0,0,0,0,0,0,0
ВРБАС,444,ПРАТЕЋИ ТРОШКОВИ ЗАДУЖИВАЊА (од 5275 до 5277),0,0,0,0,0,5,5
ВРБАС,451,СУБВЕНЦИЈЕ ЈАВНИМ НЕФИНАНСИЈСКИМ ПРЕДУЗЕЋИМА И ОРГАНИЗАЦИЈАМА (5280 + 5281),0,0,48755,0,0,66,48821
ВРБАС,452,СУБВЕНЦИЈЕ ПРИВАТНИМ ФИНАНСИЈСКИМ ИНСТИТУЦИЈАМА (5283 + 5284),0,0,0,0,0,0,0
ВРБАС,453,СУБВЕНЦИЈЕ ЈАВНИМ ФИНАНСИЈСКИМ ИНСТИТУЦИЈАМА (5286 + 5287),0,0,0,0,0,0,0
ВРБАС,454,СУБВЕНЦИЈЕ ПРИВАТНИМ ПРЕДУЗЕЋИМА (5289 + 5290),0,0,0,0,0,0,0
ВРБАС,461,ДОНАЦИЈЕ СТРАНИМ ВЛАДАМА (5293 + 5294),0,0,0,0,0,0,0
ВРБАС,462,ДОТАЦИЈЕ МЕЂУНАРОДНИМ ОРГАНИЗАЦИЈАМА (5296 + 5297),0,0,0,0,0,0,0
ВРБАС,463,ТРАНСФЕРИ ОСТАЛИМ НИВОИМА ВЛАСТИ (5299 + 5300),0,0,69187,0,0,1410,70597
ВРБАС,464,ДОТАЦИЈЕ ОРГАНИЗАЦИЈАМА ОБАВЕЗНОГ СОЦИЈАЛНОГ ОСИГУРАЊА (5302 + 5303),0,0,0,0,0,0,0
ВРБАС,465,ОСТАЛЕ ДОТАЦИЈЕ И ТРАНСФЕРИ (5305 + 5306),0,0,0,0,0,2,2
ВРБАС,471,ПРАВА ИЗ СОЦИЈАЛНОГ ОСИГУРАЊА (ОРГАНИЗАЦИЈЕ ОБАВЕЗНОГ СОЦИЈАЛНОГ ОСИГУРАЊА) (од 5309 до 5311),0,0,0,0,0,0,0
ВРБАС,472,НАКНАДЕ ЗА СОЦИЈАЛНУ ЗАШТИТУ ИЗ БУЏЕТА (од 5313 до 5321),0,0,15339,0,0,1473,16812
ВРБАС,481,ДОТАЦИЈЕ НЕВЛАДИНИМ ОРГАНИЗАЦИЈАМА (5324 + 5325),0,0,24169,0,0,821,24990
ВРБАС,482,"ПОРЕЗИ, ОБАВЕЗНЕ ТАКСЕ И КАЗНЕ (од 5327 до 5329)",0,0,1806,0,0,422,2228
ВРБАС,483,НОВЧАНЕ КАЗНЕ И ПЕНАЛИ ПО РЕШЕЊУ СУДОВА (5331),0,0,2509,0,0,39,2548
ВРБАС,484,НАКНАДА ШТЕТЕ ЗА ПОВРЕДЕ ИЛИ ШТЕТУ НАСТАЛУ УСЛЕД ЕЛЕМЕНТАРНИХ НЕПОГОДА ИЛИ ДРУГИХ ПРИРОДНИХ УЗРОКА (5333 + 5334),0,0,0,0,0,0,0
ВРБАС,485,НАКНАДА ШТЕТЕ ЗА ПОВРЕДЕ ИЛИ ШТЕТУ НАНЕТУ ОД СТРАНЕ ДРЖАВНИХ ОРГАНА (5336),0,0,1852,0,0,0,1852
ВРБАС,489,РАСХОДИ КОЈИ СЕ ФИНАНСИРАЈУ ИЗ СРЕДСТАВА ЗА РЕАЛИЗАЦИЈУ НАЦИОНАЛНОГ ИНВЕСТИЦИОНОГ ПЛАНА (5338),0,0,0,0,0,0,0
ВРБАС,511,ЗГРАДЕ И ГРАЂЕВИНСКИ ОБЈЕКТИ (од 5342 до 5345),0,0,24167,0,10193,0,34360
ВРБАС,512,МАШИНЕ И ОПРЕМА (од 5347 до 5355),0,0,13216,0,30,2909,16155
ВРБАС,513,ОСТАЛЕ НЕКРЕТНИНЕ И ОПРЕМА (5357),0,0,0,0,0,0,0
ВРБАС,514,КУЛТИВИСАНА ИМОВИНА (5359),0,0,0,0,0,0,0
ВРБАС,515,НЕМАТЕРИЈАЛНА ИМОВИНА (5361),0,0,0,0,0,0,0
ВРБАС,521,РОБНЕ РЕЗЕРВЕ (5364),0,0,0,0,0,0,0
ВРБАС,522,ЗАЛИХЕ ПРОИЗВОДЊЕ (од 5366 до 5368),0,0,0,0,0,0,0
ВРБАС,523,ЗАЛИХЕ РОБЕ ЗА ДАЉУ ПРОДАЈУ (5370),0,0,0,0,0,0,0
ВРБАС,531,ДРАГОЦЕНОСТИ (5373),0,0,0,0,0,0,0
ВРБАС,541,ЗЕМЉИШТЕ (5376),0,0,775,0,0,0,775
ВРБАС,542,РУДНА БОГАТСТВА (5378),0,0,0,0,0,0,0
ВРБАС,543,ШУМЕ И ВОДЕ (5380 + 5381),0,0,0,0,0,0,0
ВРБАС,551,НЕФИНАНСИЈСКА ИМОВИНА КОЈА СЕ ФИНАНСИРА ИЗ СРЕДСТАВА ЗА РЕАЛИЗАЦИЈУ НАЦИОНАЛНОГ ИНВЕСТИЦИОНОГ ПЛАНА (5384),0,0,0,0,0,0,0
ВРБАС,611,ОТПЛАТА ГЛАВНИЦЕ ДОМАЋИМ КРЕДИТОРИМА (од 5388 до 5396),0,759,58981,0,0,193,59933
ВРБАС,612,ОТПЛАТА ГЛАВНИЦЕ СТРАНИМ КРЕДИТОРИМА (од 5398 до 5404),0,0,0,0,0,0,0
ВРБАС,613,ОТПЛАТА ГЛАВНИЦЕ ПО ГАРАНЦИЈАМА (5406),0,0,0,0,0,0,0
ВРБАС,614,ОТПЛАТА ГЛАВНИЦЕ ЗА ФИНАНСИЈСКИ ЛИЗИНГ (5408),0,0,824,0,0,298,1122
ВРБАС,621,НАБАВКА ДОМАЋЕ ФИНАНСИЈСКЕ ИМОВИНЕ (од 5411 до 5419),0,0,49,0,0,0,49
ВРБАС,622,НАБАВКА СТРАНЕ ФИНАНСИЈСКЕ ИМОВИНЕ (од 5421 до 5428),0,0,0,0,0,0,0
ВРБАС,623,НАБАВКА ФИНАНСИЈСКЕ ИМОВИНЕ КОЈА СЕ ФИНАНСИРА ИЗ СРЕДСТАВА ЗА РЕАЛИЗАЦИЈУ НАЦИОНАЛНОГ ИНВЕСТИЦИОНОГ ПЛАНА (5430),0,0,0,0,0,0,0
ТИТЕЛ,411,"ПЛАТЕ, ДОДАЦИ И НАКНАДЕ ЗАПОСЛЕНИХ (ЗАРАДЕ) (5174)",4784,0,40611,0,0,1206,46601
ТИТЕЛ,412,СОЦИЈАЛНИ ДОПРИНОСИ НА ТЕРЕТ ПОСЛОДАВЦА (од 5176 до 5178),1265,0,6949,0,0,127,8341
ТИТЕЛ,413,НАКНАДЕ У НАТУРИ (5180),5,0,72,0,0,134,211
ТИТЕЛ,414,СОЦИЈАЛНА ДАВАЊА ЗАПОСЛЕНИМА (од 5182 до 5185),0,0,399,262,0,231,892
ТИТЕЛ,415,НАКНАДА ТРОШКОВА ЗА ЗАПОСЛЕНЕ (5187),0,0,672,0,0,92,764
ТИТЕЛ,416,НАГРАДЕ ЗАПОСЛЕНИМА И ОСТАЛИ ПОСЕБНИ РАСХОДИ (5189),0,0,0,0,0,0,0
ТИТЕЛ,417,ПОСЛАНИЧКИ ДОДАТАК (5191),0,0,1616,0,0,0,1616
ТИТЕЛ,418,СУДИЈСКИ ДОДАТАК (5193),0,0,0,0,0,0,0
ТИТЕЛ,421,СТАЛНИ ТРОШКОВИ (од 5196 до 5202),53,0,11206,0,0,596,11855
ТИТЕЛ,422,ТРОШКОВИ ПУТОВАЊА (од 5204 до 5208),0,1,5669,0,0,203,5873
ТИТЕЛ,423,УСЛУГЕ ПО УГОВОРУ (од 5210 до 5217),94,0,14155,0,0,805,15054
ТИТЕЛ,424,СПЕЦИЈАЛИЗОВАНЕ УСЛУГЕ (од 5219 до 5225),35,1646,12577,0,0,676,14934
ТИТЕЛ,425,ТЕКУЋЕ ПОПРАВКЕ И ОДРЖАВАЊЕ (5227 + 5228),0,0,5590,0,0,813,6403
ТИТЕЛ,426,МАТЕРИЈАЛ (од 5230 до 5238),21,1,4110,0,0,2237,6369
ТИТЕЛ,431,АМОРТИЗАЦИЈА НЕКРЕТНИНА И ОПРЕМЕ (од 5241 до 5243),0,0,0,0,0,0,0
ТИТЕЛ,432,АМОРТИЗАЦИЈА КУЛТИВИСАНЕ ИМОВИНЕ (5245),0,0,0,0,0,0,0
ТИТЕЛ,433,УПОТРЕБА ДРАГОЦЕНОСТИ (5247),0,0,0,0,0,0,0
ТИТЕЛ,434,УПОТРЕБА ПРИРОДНЕ ИМОВИНЕ (од 5249 до 5251),0,0,0,0,0,0,0
ТИТЕЛ,435,АМОРТИЗАЦИЈА НЕМАТЕРИЈАЛНЕ ИМОВИНЕ (5253),0,0,0,0,0,0,0
ТИТЕЛ,441,ОТПЛАТЕ ДОМАЋИХ КАМАТА (од 5256 до 5264),0,0,2589,0,0,15,2604
ТИТЕЛ,442,ОТПЛАТА СТРАНИХ КАМАТА (од 5266 до 5271),0,0,0,0,0,0,0
ТИТЕЛ,443,ОТПЛАТА КАМАТА ПО ГАРАНЦИЈАМА (5273),0,0,0,0,0,0,0
ТИТЕЛ,444,ПРАТЕЋИ ТРОШКОВИ ЗАДУЖИВАЊА (од 5275 до 5277),0,0,1709,0,0,81,1790
ТИТЕЛ,451,СУБВЕНЦИЈЕ ЈАВНИМ НЕФИНАНСИЈСКИМ ПРЕДУЗЕЋИМА И ОРГАНИЗАЦИЈАМА (5280 + 5281),0,0,1697,0,0,0,1697
ТИТЕЛ,452,СУБВЕНЦИЈЕ ПРИВАТНИМ ФИНАНСИЈСКИМ ИНСТИТУЦИЈАМА (5283 + 5284),0,0,0,0,0,0,0
ТИТЕЛ,453,СУБВЕНЦИЈЕ ЈАВНИМ ФИНАНСИЈСКИМ ИНСТИТУЦИЈАМА (5286 + 5287),0,0,0,0,0,0,0
ТИТЕЛ,454,СУБВЕНЦИЈЕ ПРИВАТНИМ ПРЕДУЗЕЋИМА (5289 + 5290),0,0,0,0,0,0,0
ТИТЕЛ,461,ДОНАЦИЈЕ СТРАНИМ ВЛАДАМА (5293 + 5294),0,0,0,0,0,0,0
ТИТЕЛ,462,ДОТАЦИЈЕ МЕЂУНАРОДНИМ ОРГАНИЗАЦИЈАМА (5296 + 5297),0,0,0,0,0,0,0
ТИТЕЛ,463,ТРАНСФЕРИ ОСТАЛИМ НИВОИМА ВЛАСТИ (5299 + 5300),0,0,31763,0,0,0,31763
ТИТЕЛ,464,ДОТАЦИЈЕ ОРГАНИЗАЦИЈАМА ОБАВЕЗНОГ СОЦИЈАЛНОГ ОСИГУРАЊА (5302 + 5303),0,0,0,0,0,0,0
ТИТЕЛ,465,ОСТАЛЕ ДОТАЦИЈЕ И ТРАНСФЕРИ (5305 + 5306),0,0,0,0,0,0,0
ТИТЕЛ,471,ПРАВА ИЗ СОЦИЈАЛНОГ ОСИГУРАЊА (ОРГАНИЗАЦИЈЕ ОБАВЕЗНОГ СОЦИЈАЛНОГ ОСИГУРАЊА) (од 5309 до 5311),0,0,0,0,0,0,0
ТИТЕЛ,472,НАКНАДЕ ЗА СОЦИЈАЛНУ ЗАШТИТУ ИЗ БУЏЕТА (од 5313 до 5321),0,0,6032,0,0,0,6032
ТИТЕЛ,481,ДОТАЦИЈЕ НЕВЛАДИНИМ ОРГАНИЗАЦИЈАМА (5324 + 5325),0,0,7158,0,0,45,7203
ТИТЕЛ,482,"ПОРЕЗИ, ОБАВЕЗНЕ ТАКСЕ И КАЗНЕ (од 5327 до 5329)",0,0,18,0,0,56,74
ТИТЕЛ,483,НОВЧАНЕ КАЗНЕ И ПЕНАЛИ ПО РЕШЕЊУ СУДОВА (5331),0,0,48,0,0,0,48
ТИТЕЛ,484,НАКНАДА ШТЕТЕ ЗА ПОВРЕДЕ ИЛИ ШТЕТУ НАСТАЛУ УСЛЕД ЕЛЕМЕНТАРНИХ НЕПОГОДА ИЛИ ДРУГИХ ПРИРОДНИХ УЗРОКА (5333 + 5334),0,0,1000,0,0,0,1000
ТИТЕЛ,485,НАКНАДА ШТЕТЕ ЗА ПОВРЕДЕ ИЛИ ШТЕТУ НАНЕТУ ОД СТРАНЕ ДРЖАВНИХ ОРГАНА (5336),0,0,0,0,0,0,0
ТИТЕЛ,489,РАСХОДИ КОЈИ СЕ ФИНАНСИРАЈУ ИЗ СРЕДСТАВА ЗА РЕАЛИЗАЦИЈУ НАЦИОНАЛНОГ ИНВЕСТИЦИОНОГ ПЛАНА (5338),0,0,0,0,0,0,0
ТИТЕЛ,511,ЗГРАДЕ И ГРАЂЕВИНСКИ ОБЈЕКТИ (од 5342 до 5345),0,11940,25162,0,352,1976,39430
ТИТЕЛ,512,МАШИНЕ И ОПРЕМА (од 5347 до 5355),36,0,2219,0,0,146,2401
ТИТЕЛ,513,ОСТАЛЕ НЕКРЕТНИНЕ И ОПРЕМА (5357),0,0,0,0,0,0,0
ТИТЕЛ,514,КУЛТИВИСАНА ИМОВИНА (5359),0,0,0,0,0,0,0
ТИТЕЛ,515,НЕМАТЕРИЈАЛНА ИМОВИНА (5361),0,0,1106,0,0,109,1215
ТИТЕЛ,521,РОБНЕ РЕЗЕРВЕ (5364),0,0,0,0,0,0,0
ТИТЕЛ,522,ЗАЛИХЕ ПРОИЗВОДЊЕ (од 5366 до 5368),0,0,0,0,0,0,0
ТИТЕЛ,523,ЗАЛИХЕ РОБЕ ЗА ДАЉУ ПРОДАЈУ (5370),0,0,0,0,0,0,0
ТИТЕЛ,531,ДРАГОЦЕНОСТИ (5373),0,0,0,0,0,0,0
ТИТЕЛ,541,ЗЕМЉИШТЕ (5376),0,0,0,0,0,0,0
ТИТЕЛ,542,РУДНА БОГАТСТВА (5378),0,0,0,0,0,0,0
ТИТЕЛ,543,ШУМЕ И ВОДЕ (5380 + 5381),0,0,0,0,0,0,0
ТИТЕЛ,551,НЕФИНАНСИЈСКА ИМОВИНА КОЈА СЕ ФИНАНСИРА ИЗ СРЕДСТАВА ЗА РЕАЛИЗАЦИЈУ НАЦИОНАЛНОГ ИНВЕСТИЦИОНОГ ПЛАНА (5384),0,0,0,0,0,0,0
ТИТЕЛ,611,ОТПЛАТА ГЛАВНИЦЕ ДОМАЋИМ КРЕДИТОРИМА (од 5388 до 5396),0,0,7158,0,0,77,7235
ТИТЕЛ,612,ОТПЛАТА ГЛАВНИЦЕ СТРАНИМ КРЕДИТОРИМА (од 5398 до 5404),0,0,0,0,0,0,0
ТИТЕЛ,613,ОТПЛАТА ГЛАВНИЦЕ ПО ГАРАНЦИЈАМА (5406),0,0,0,0,0,0,0
ТИТЕЛ,614,ОТПЛАТА ГЛАВНИЦЕ ЗА ФИНАНСИЈСКИ ЛИЗИНГ (5408),0,0,0,0,0,0,0
ТИТЕЛ,621,НАБАВКА ДОМАЋЕ ФИНАНСИЈСКЕ ИМОВИНЕ (од 5411 до 5419),0,0,49,0,0,0,49
ТИТЕЛ,622,НАБАВКА СТРАНЕ ФИНАНСИЈСКЕ ИМОВИНЕ (од 5421 до 5428),0,0,0,0,0,0,0
ТИТЕЛ,623,НАБАВКА ФИНАНСИЈСКЕ ИМОВИНЕ КОЈА СЕ ФИНАНСИРА ИЗ СРЕДСТАВА ЗА РЕАЛИЗАЦИЈУ НАЦИОНАЛНОГ ИНВЕСТИЦИОНОГ ПЛАНА (5430),0,0,0,0,0,0,0
ТЕМЕРИН,411,"ПЛАТЕ, ДОДАЦИ И НАКНАДЕ ЗАПОСЛЕНИХ (ЗАРАДЕ) (5174)",4304,0,124404,0,0,5698,134406
ТЕМЕРИН,412,СОЦИЈАЛНИ ДОПРИНОСИ НА ТЕРЕТ ПОСЛОДАВЦА (од 5176 до 5178),346,0,22069,0,0,1644,24059
ТЕМЕРИН,413,НАКНАДЕ У НАТУРИ (5180),0,0,0,0,0,0,0
ТЕМЕРИН,414,СОЦИЈАЛНА ДАВАЊА ЗАПОСЛЕНИМА (од 5182 до 5185),386,0,3741,537,0,369,5033
ТЕМЕРИН,415,НАКНАДА ТРОШКОВА ЗА ЗАПОСЛЕНЕ (5187),0,0,3973,0,0,132,4105
ТЕМЕРИН,416,НАГРАДЕ ЗАПОСЛЕНИМА И ОСТАЛИ ПОСЕБНИ РАСХОДИ (5189),0,0,30,0,0,0,30
ТЕМЕРИН,417,ПОСЛАНИЧКИ ДОДАТАК (5191),0,0,3212,0,0,0,3212
ТЕМЕРИН,418,СУДИЈСКИ ДОДАТАК (5193),0,0,0,0,0,0,0
ТЕМЕРИН,421,СТАЛНИ ТРОШКОВИ (од 5196 до 5202),155,0,38259,0,12,3344,41770
ТЕМЕРИН,422,ТРОШКОВИ ПУТОВАЊА (од 5204 до 5208),122,23,1744,0,0,1284,3173
ТЕМЕРИН,423,УСЛУГЕ ПО УГОВОРУ (од 5210 до 5217),140,24,35198,0,202,2170,37734
ТЕМЕРИН,424,СПЕЦИЈАЛИЗОВАНЕ УСЛУГЕ (од 5219 до 5225),1,2000,32255,0,0,4301,38557
ТЕМЕРИН,425,ТЕКУЋЕ ПОПРАВКЕ И ОДРЖАВАЊЕ (5227 + 5228),136,0,17267,0,0,1322,18725
ТЕМЕРИН,426,МАТЕРИЈАЛ (од 5230 до 5238),793,7,10510,0,2,10521,21833
ТЕМЕРИН,431,АМОРТИЗАЦИЈА НЕКРЕТНИНА И ОПРЕМЕ (од 5241 до 5243),228,0,0,0,0,179,407
ТЕМЕРИН,432,АМОРТИЗАЦИЈА КУЛТИВИСАНЕ ИМОВИНЕ (5245),0,0,0,0,0,0,0
ТЕМЕРИН,433,УПОТРЕБА ДРАГОЦЕНОСТИ (5247),0,0,0,0,0,0,0
ТЕМЕРИН,434,УПОТРЕБА ПРИРОДНЕ ИМОВИНЕ (од 5249 до 5251),0,0,0,0,0,0,0
ТЕМЕРИН,435,АМОРТИЗАЦИЈА НЕМАТЕРИЈАЛНЕ ИМОВИНЕ (5253),0,0,0,0,0,0,0
ТЕМЕРИН,441,ОТПЛАТЕ ДОМАЋИХ КАМАТА (од 5256 до 5264),0,0,1321,0,0,0,1321
ТЕМЕРИН,442,ОТПЛАТА СТРАНИХ КАМАТА (од 5266 до 5271),0,0,0,0,0,0,0
ТЕМЕРИН,443,ОТПЛАТА КАМАТА ПО ГАРАНЦИЈАМА (5273),0,0,0,0,0,0,0
ТЕМЕРИН,444,ПРАТЕЋИ ТРОШКОВИ ЗАДУЖИВАЊА (од 5275 до 5277),0,0,1,0,0,0,1
ТЕМЕРИН,451,СУБВЕНЦИЈЕ ЈАВНИМ НЕФИНАНСИЈСКИМ ПРЕДУЗЕЋИМА И ОРГАНИЗАЦИЈАМА (5280 + 5281),0,0,24795,0,0,1000,25795
ТЕМЕРИН,452,СУБВЕНЦИЈЕ ПРИВАТНИМ ФИНАНСИЈСКИМ ИНСТИТУЦИЈАМА (5283 + 5284),0,0,0,0,0,0,0
ТЕМЕРИН,453,СУБВЕНЦИЈЕ ЈАВНИМ ФИНАНСИЈСКИМ ИНСТИТУЦИЈАМА (5286 + 5287),0,0,0,0,0,0,0
ТЕМЕРИН,454,СУБВЕНЦИЈЕ ПРИВАТНИМ ПРЕДУЗЕЋИМА (5289 + 5290),0,0,0,0,0,0,0
ТЕМЕРИН,461,ДОНАЦИЈЕ СТРАНИМ ВЛАДАМА (5293 + 5294),0,0,0,0,0,0,0
ТЕМЕРИН,462,ДОТАЦИЈЕ МЕЂУНАРОДНИМ ОРГАНИЗАЦИЈАМА (5296 + 5297),0,0,0,0,0,0,0
ТЕМЕРИН,463,ТРАНСФЕРИ ОСТАЛИМ НИВОИМА ВЛАСТИ (5299 + 5300),0,0,74359,0,0,0,74359
ТЕМЕРИН,464,ДОТАЦИЈЕ ОРГАНИЗАЦИЈАМА ОБАВЕЗНОГ СОЦИЈАЛНОГ ОСИГУРАЊА (5302 + 5303),0,0,0,0,0,0,0
ТЕМЕРИН,465,ОСТАЛЕ ДОТАЦИЈЕ И ТРАНСФЕРИ (5305 + 5306),0,0,274,0,0,0,274
ТЕМЕРИН,471,ПРАВА ИЗ СОЦИЈАЛНОГ ОСИГУРАЊА (ОРГАНИЗАЦИЈЕ ОБАВЕЗНОГ СОЦИЈАЛНОГ ОСИГУРАЊА) (од 5309 до 5311),0,0,0,0,0,0,0
ТЕМЕРИН,472,НАКНАДЕ ЗА СОЦИЈАЛНУ ЗАШТИТУ ИЗ БУЏЕТА (од 5313 до 5321),0,4804,11263,0,0,0,16067
ТЕМЕРИН,481,ДОТАЦИЈЕ НЕВЛАДИНИМ ОРГАНИЗАЦИЈАМА (5324 + 5325),0,0,24252,0,0,277,24529
ТЕМЕРИН,482,"ПОРЕЗИ, ОБАВЕЗНЕ ТАКСЕ И КАЗНЕ (од 5327 до 5329)",0,1,463,0,0,119,583
ТЕМЕРИН,483,НОВЧАНЕ КАЗНЕ И ПЕНАЛИ ПО РЕШЕЊУ СУДОВА (5331),0,0,1399,0,0,0,1399
ТЕМЕРИН,484,НАКНАДА ШТЕТЕ ЗА ПОВРЕДЕ ИЛИ ШТЕТУ НАСТАЛУ УСЛЕД ЕЛЕМЕНТАРНИХ НЕПОГОДА ИЛИ ДРУГИХ ПРИРОДНИХ УЗРОКА (5333 + 5334),0,0,2599,0,0,0,2599
ТЕМЕРИН,485,НАКНАДА ШТЕТЕ ЗА ПОВРЕДЕ ИЛИ ШТЕТУ НАНЕТУ ОД СТРАНЕ ДРЖАВНИХ ОРГАНА (5336),0,0,0,0,0,532,532
ТЕМЕРИН,489,РАСХОДИ КОЈИ СЕ ФИНАНСИРАЈУ ИЗ СРЕДСТАВА ЗА РЕАЛИЗАЦИЈУ НАЦИОНАЛНОГ ИНВЕСТИЦИОНОГ ПЛАНА (5338),0,0,0,0,0,0,0
ТЕМЕРИН,511,ЗГРАДЕ И ГРАЂЕВИНСКИ ОБЈЕКТИ (од 5342 до 5345),0,1500,55970,0,0,0,57470
ТЕМЕРИН,512,МАШИНЕ И ОПРЕМА (од 5347 до 5355),1036,0,4417,0,0,118,5571
ТЕМЕРИН,513,ОСТАЛЕ НЕКРЕТНИНЕ И ОПРЕМА (5357),0,0,0,0,0,0,0
ТЕМЕРИН,514,КУЛТИВИСАНА ИМОВИНА (5359),0,0,0,0,0,0,0
ТЕМЕРИН,515,НЕМАТЕРИЈАЛНА ИМОВИНА (5361),0,0,656,0,70,0,726
ТЕМЕРИН,521,РОБНЕ РЕЗЕРВЕ (5364),0,0,0,0,0,0,0
ТЕМЕРИН,522,ЗАЛИХЕ ПРОИЗВОДЊЕ (од 5366 до 5368),0,0,0,0,0,0,0
ТЕМЕРИН,523,ЗАЛИХЕ РОБЕ ЗА ДАЉУ ПРОДАЈУ (5370),0,0,0,0,0,0,0
ТЕМЕРИН,531,ДРАГОЦЕНОСТИ (5373),0,0,0,0,0,0,0
ТЕМЕРИН,541,ЗЕМЉИШТЕ (5376),0,0,0,0,0,0,0
ТЕМЕРИН,542,РУДНА БОГАТСТВА (5378),0,1000,0,0,0,0,1000
ТЕМЕРИН,543,ШУМЕ И ВОДЕ (5380 + 5381),0,0,0,0,0,0,0
ТЕМЕРИН,551,НЕФИНАНСИЈСКА ИМОВИНА КОЈА СЕ ФИНАНСИРА ИЗ СРЕДСТАВА ЗА РЕАЛИЗАЦИЈУ НАЦИОНАЛНОГ ИНВЕСТИЦИОНОГ ПЛАНА (5384),0,0,0,0,0,0,0
ТЕМЕРИН,611,ОТПЛАТА ГЛАВНИЦЕ ДОМАЋИМ КРЕДИТОРИМА (од 5388 до 5396),0,0,864,0,0,0,864
ТЕМЕРИН,612,ОТПЛАТА ГЛАВНИЦЕ СТРАНИМ КРЕДИТОРИМА (од 5398 до 5404),0,0,0,0,0,0,0
ТЕМЕРИН,613,ОТПЛАТА ГЛАВНИЦЕ ПО ГАРАНЦИЈАМА (5406),0,0,0,0,0,0,0
ТЕМЕРИН,614,ОТПЛАТА ГЛАВНИЦЕ ЗА ФИНАНСИЈСКИ ЛИЗИНГ (5408),0,0,0,0,0,0,0
ТЕМЕРИН,621,НАБАВКА ДОМАЋЕ ФИНАНСИЈСКЕ ИМОВИНЕ (од 5411 до 5419),0,0,0,0,0,0,0
ТЕМЕРИН,622,НАБАВКА СТРАНЕ ФИНАНСИЈСКЕ ИМОВИНЕ (од 5421 до 5428),0,0,0,0,0,0,0
ТЕМЕРИН,623,НАБАВКА ФИНАНСИЈСКЕ ИМОВИНЕ КОЈА СЕ ФИНАНСИРА ИЗ СРЕДСТАВА ЗА РЕАЛИЗАЦИЈУ НАЦИОНАЛНОГ ИНВЕСТИЦИОНОГ ПЛАНА (5430),0,0,0,0,0,0,0
АЛЕКСИНАЦ,411,"ПЛАТЕ, ДОДАЦИ И НАКНАДЕ ЗАПОСЛЕНИХ (ЗАРАДЕ) (5174)",167354,0,0,0,0,5601,172955
АЛЕКСИНАЦ,412,СОЦИЈАЛНИ ДОПРИНОСИ НА ТЕРЕТ ПОСЛОДАВЦА (од 5176 до 5178),29991,0,0,0,0,1041,31032
АЛЕКСИНАЦ,413,НАКНАДЕ У НАТУРИ (5180),0,0,3072,0,0,84,3156
АЛЕКСИНАЦ,414,СОЦИЈАЛНА ДАВАЊА ЗАПОСЛЕНИМА (од 5182 до 5185),0,0,12897,0,0,1437,14334
АЛЕКСИНАЦ,415,НАКНАДА ТРОШКОВА ЗА ЗАПОСЛЕНЕ (5187),0,0,2422,0,0,75,2497
АЛЕКСИНАЦ,416,НАГРАДЕ ЗАПОСЛЕНИМА И ОСТАЛИ ПОСЕБНИ РАСХОДИ (5189),0,0,6,0,0,34,40
АЛЕКСИНАЦ,417,ПОСЛАНИЧКИ ДОДАТАК (5191),0,0,0,0,0,0,0
АЛЕКСИНАЦ,418,СУДИЈСКИ ДОДАТАК (5193),0,0,0,0,0,0,0
АЛЕКСИНАЦ,421,СТАЛНИ ТРОШКОВИ (од 5196 до 5202),1167,0,34791,0,829,2371,39158
АЛЕКСИНАЦ,422,ТРОШКОВИ ПУТОВАЊА (од 5204 до 5208),0,0,12204,0,0,1064,13268
АЛЕКСИНАЦ,423,УСЛУГЕ ПО УГОВОРУ (од 5210 до 5217),0,0,12742,0,0,9762,22504
АЛЕКСИНАЦ,424,СПЕЦИЈАЛИЗОВАНЕ УСЛУГЕ (од 5219 до 5225),54,0,94832,0,0,2391,97277
АЛЕКСИНАЦ,425,ТЕКУЋЕ ПОПРАВКЕ И ОДРЖАВАЊЕ (5227 + 5228),84,0,4513,0,0,2546,7143
АЛЕКСИНАЦ,426,МАТЕРИЈАЛ (од 5230 до 5238),1955,0,13553,0,0,5582,21090
АЛЕКСИНАЦ,431,АМОРТИЗАЦИЈА НЕКРЕТНИНА И ОПРЕМЕ (од 5241 до 5243),0,0,0,0,0,1419,1419
АЛЕКСИНАЦ,432,АМОРТИЗАЦИЈА КУЛТИВИСАНЕ ИМОВИНЕ (5245),0,0,0,0,0,0,0
АЛЕКСИНАЦ,433,УПОТРЕБА ДРАГОЦЕНОСТИ (5247),0,0,0,0,0,0,0
АЛЕКСИНАЦ,434,УПОТРЕБА ПРИРОДНЕ ИМОВИНЕ (од 5249 до 5251),0,0,0,0,0,0,0
АЛЕКСИНАЦ,435,АМОРТИЗАЦИЈА НЕМАТЕРИЈАЛНЕ ИМОВИНЕ (5253),0,0,0,0,0,0,0
АЛЕКСИНАЦ,441,ОТПЛАТЕ ДОМАЋИХ КАМАТА (од 5256 до 5264),0,0,1360,0,0,0,1360
АЛЕКСИНАЦ,442,ОТПЛАТА СТРАНИХ КАМАТА (од 5266 до 5271),0,0,0,0,0,0,0
АЛЕКСИНАЦ,443,ОТПЛАТА КАМАТА ПО ГАРАНЦИЈАМА (5273),0,0,0,0,0,0,0
АЛЕКСИНАЦ,444,ПРАТЕЋИ ТРОШКОВИ ЗАДУЖИВАЊА (од 5275 до 5277),0,0,0,0,0,0,0
АЛЕКСИНАЦ,451,СУБВЕНЦИЈЕ ЈАВНИМ НЕФИНАНСИЈСКИМ ПРЕДУЗЕЋИМА И ОРГАНИЗАЦИЈАМА (5280 + 5281),0,0,22342,0,0,21,22363
АЛЕКСИНАЦ,452,СУБВЕНЦИЈЕ ПРИВАТНИМ ФИНАНСИЈСКИМ ИНСТИТУЦИЈАМА (5283 + 5284),0,0,0,0,0,0,0
АЛЕКСИНАЦ,453,СУБВЕНЦИЈЕ ЈАВНИМ ФИНАНСИЈСКИМ ИНСТИТУЦИЈАМА (5286 + 5287),0,0,0,0,0,0,0
АЛЕКСИНАЦ,454,СУБВЕНЦИЈЕ ПРИВАТНИМ ПРЕДУЗЕЋИМА (5289 + 5290),0,0,0,0,0,0,0
АЛЕКСИНАЦ,461,ДОНАЦИЈЕ СТРАНИМ ВЛАДАМА (5293 + 5294),0,0,0,0,0,0,0
АЛЕКСИНАЦ,462,ДОТАЦИЈЕ МЕЂУНАРОДНИМ ОРГАНИЗАЦИЈАМА (5296 + 5297),0,0,0,0,0,0,0
АЛЕКСИНАЦ,463,ТРАНСФЕРИ ОСТАЛИМ НИВОИМА ВЛАСТИ (5299 + 5300),74155,0,0,0,0,0,74155
АЛЕКСИНАЦ,464,ДОТАЦИЈЕ ОРГАНИЗАЦИЈАМА ОБАВЕЗНОГ СОЦИЈАЛНОГ ОСИГУРАЊА (5302 + 5303),0,0,0,0,0,0,0
АЛЕКСИНАЦ,465,ОСТАЛЕ ДОТАЦИЈЕ И ТРАНСФЕРИ (5305 + 5306),0,0,0,0,0,0,0
АЛЕКСИНАЦ,471,ПРАВА ИЗ СОЦИЈАЛНОГ ОСИГУРАЊА (ОРГАНИЗАЦИЈЕ ОБАВЕЗНОГ СОЦИЈАЛНОГ ОСИГУРАЊА) (од 5309 до 5311),0,0,0,0,0,0,0
АЛЕКСИНАЦ,472,НАКНАДЕ ЗА СОЦИЈАЛНУ ЗАШТИТУ ИЗ БУЏЕТА (од 5313 до 5321),8061,0,7913,0,0,32,16006
АЛЕКСИНАЦ,481,ДОТАЦИЈЕ НЕВЛАДИНИМ ОРГАНИЗАЦИЈАМА (5324 + 5325),0,0,20350,0,0,728,21078
АЛЕКСИНАЦ,482,"ПОРЕЗИ, ОБАВЕЗНЕ ТАКСЕ И КАЗНЕ (од 5327 до 5329)",0,0,2425,0,0,861,3286
АЛЕКСИНАЦ,483,НОВЧАНЕ КАЗНЕ И ПЕНАЛИ ПО РЕШЕЊУ СУДОВА (5331),0,0,8672,0,0,413,9085
АЛЕКСИНАЦ,484,НАКНАДА ШТЕТЕ ЗА ПОВРЕДЕ ИЛИ ШТЕТУ НАСТАЛУ УСЛЕД ЕЛЕМЕНТАРНИХ НЕПОГОДА ИЛИ ДРУГИХ ПРИРОДНИХ УЗРОКА (5333 + 5334),0,0,21181,0,0,0,21181
АЛЕКСИНАЦ,485,НАКНАДА ШТЕТЕ ЗА ПОВРЕДЕ ИЛИ ШТЕТУ НАНЕТУ ОД СТРАНЕ ДРЖАВНИХ ОРГАНА (5336),0,0,0,0,0,0,0
АЛЕКСИНАЦ,489,РАСХОДИ КОЈИ СЕ ФИНАНСИРАЈУ ИЗ СРЕДСТАВА ЗА РЕАЛИЗАЦИЈУ НАЦИОНАЛНОГ ИНВЕСТИЦИОНОГ ПЛАНА (5338),0,0,0,0,0,0,0
АЛЕКСИНАЦ,511,ЗГРАДЕ И ГРАЂЕВИНСКИ ОБЈЕКТИ (од 5342 до 5345),23595,0,100353,0,820,10400,135168
АЛЕКСИНАЦ,512,МАШИНЕ И ОПРЕМА (од 5347 до 5355),0,0,1768,0,0,1096,2864
АЛЕКСИНАЦ,513,ОСТАЛЕ НЕКРЕТНИНЕ И ОПРЕМА (5357),0,0,0,0,0,0,0
АЛЕКСИНАЦ,514,КУЛТИВИСАНА ИМОВИНА (5359),0,0,0,0,0,0,0
АЛЕКСИНАЦ,515,НЕМАТЕРИЈАЛНА ИМОВИНА (5361),0,0,372,0,0,25,397
АЛЕКСИНАЦ,521,РОБНЕ РЕЗЕРВЕ (5364),0,0,0,0,0,0,0
АЛЕКСИНАЦ,522,ЗАЛИХЕ ПРОИЗВОДЊЕ (од 5366 до 5368),0,0,0,0,0,0,0
АЛЕКСИНАЦ,523,ЗАЛИХЕ РОБЕ ЗА ДАЉУ ПРОДАЈУ (5370),0,0,0,0,0,77,77
АЛЕКСИНАЦ,531,ДРАГОЦЕНОСТИ (5373),0,0,0,0,0,0,0
АЛЕКСИНАЦ,541,ЗЕМЉИШТЕ (5376),0,0,75,0,0,376,451
АЛЕКСИНАЦ,542,РУДНА БОГАТСТВА (5378),0,0,0,0,0,0,0
АЛЕКСИНАЦ,543,ШУМЕ И ВОДЕ (5380 + 5381),0,0,0,0,0,0,0
АЛЕКСИНАЦ,551,НЕФИНАНСИЈСКА ИМОВИНА КОЈА СЕ ФИНАНСИРА ИЗ СРЕДСТАВА ЗА РЕАЛИЗАЦИЈУ НАЦИОНАЛНОГ ИНВЕСТИЦИОНОГ ПЛАНА (5384),0,0,0,0,0,0,0
АЛЕКСИНАЦ,611,ОТПЛАТА ГЛАВНИЦЕ ДОМАЋИМ КРЕДИТОРИМА (од 5388 до 5396),0,0,0,0,0,0,0
АЛЕКСИНАЦ,612,ОТПЛАТА ГЛАВНИЦЕ СТРАНИМ КРЕДИТОРИМА (од 5398 до 5404),0,0,0,0,0,0,0
АЛЕКСИНАЦ,613,ОТПЛАТА ГЛАВНИЦЕ ПО ГАРАНЦИЈАМА (5406),0,0,0,0,0,0,0
АЛЕКСИНАЦ,614,ОТПЛАТА ГЛАВНИЦЕ ЗА ФИНАНСИЈСКИ ЛИЗИНГ (5408),0,0,0,0,0,0,0
АЛЕКСИНАЦ,621,НАБАВКА ДОМАЋЕ ФИНАНСИЈСКЕ ИМОВИНЕ (од 5411 до 5419),0,0,0,0,0,0,0
АЛЕКСИНАЦ,622,НАБАВКА СТРАНЕ ФИНАНСИЈСКЕ ИМОВИНЕ (од 5421 до 5428),0,0,0,0,0,0,0
АЛЕКСИНАЦ,623,НАБАВКА ФИНАНСИЈСКЕ ИМОВИНЕ КОЈА СЕ ФИНАНСИРА ИЗ СРЕДСТАВА ЗА РЕАЛИЗАЦИЈУ НАЦИОНАЛНОГ ИНВЕСТИЦИОНОГ ПЛАНА (5430),0,0,0,0,0,0,0
